"BA Code","Timestamp (Hour Ending)","Demand (MWh)","Demand Forecast (MWh)","Net Generation (MWh)","Total Interchange (MWh)"
ISNE,"5/1/2018 12 a.m. EDT",10970,10830,8950,-2020
ISNE,"5/1/2018 1 a.m. EDT",10781,9940,8589,-2192
ISNE,"5/1/2018 2 a.m. EDT",10602,9650,8292,-2310
ISNE,"5/1/2018 3 a.m. EDT",10437,9470,8083,-2354
ISNE,"5/1/2018 4 a.m. EDT",10427,9510,8101,-2326
ISNE,"5/1/2018 5 a.m. EDT",10737,9740,8649,-2088
ISNE,"5/1/2018 6 a.m. EDT",11479,10620,9629,-1850
ISNE,"5/1/2018 7 a.m. EDT",12376,12110,10836,-1540
ISNE,"5/1/2018 8 a.m. EDT",13018,12790,11423,-1595
ISNE,"5/1/2018 9 a.m. EDT",12808,12870,11156,-1652
ISNE,"5/1/2018 10 a.m. EDT",12685,12710,10953,-1732
ISNE,"5/1/2018 11 a.m. EDT",12592,12320,11013,-1579
ISNE,"5/1/2018 12 p.m. EDT",12769,12220,11114,-1655
ISNE,"5/1/2018 1 p.m. EDT",12800,11960,11186,-1614
ISNE,"5/1/2018 2 p.m. EDT",12469,11970,10722,-1747
ISNE,"5/1/2018 3 p.m. EDT",11512,12020,9696,-1816
ISNE,"5/1/2018 4 p.m. EDT",11663,12270,9990,-1673
ISNE,"5/1/2018 5 p.m. EDT",12060,12490,10690,-1370
ISNE,"5/1/2018 6 p.m. EDT",12714,12920,11133,-1581
ISNE,"5/1/2018 7 p.m. EDT",13132,13260,11355,-1777
ISNE,"5/1/2018 8 p.m. EDT",13519,13610,11643,-1876
ISNE,"5/1/2018 9 p.m. EDT",13718,14000,11770,-1948
ISNE,"5/1/2018 10 p.m. EDT",12878,13050,10817,-2061
ISNE,"5/1/2018 11 p.m. EDT",11699,11690,9631,-2068
ISNE,"5/2/2018 12 a.m. EDT",10753,10540,8645,-2108
ISNE,"5/2/2018 1 a.m. EDT",10354,9670,8077,-2277
ISNE,"5/2/2018 2 a.m. EDT",10296,9260,7908,-2388
ISNE,"5/2/2018 3 a.m. EDT",10349,9070,7851,-2498
ISNE,"5/2/2018 4 a.m. EDT",10322,9030,7843,-2479
ISNE,"5/2/2018 5 a.m. EDT",10590,9290,8280,-2310
ISNE,"5/2/2018 6 a.m. EDT",10878,10070,8910,-1968
ISNE,"5/2/2018 7 a.m. EDT",11645,11590,9828,-1817
ISNE,"5/2/2018 8 a.m. EDT",12352,12430,10482,-1870
ISNE,"5/2/2018 9 a.m. EDT",12359,12500,10325,-2034
ISNE,"5/2/2018 10 a.m. EDT",12296,12280,10281,-2015
ISNE,"5/2/2018 11 a.m. EDT",12328,12540,10404,-1924
ISNE,"5/2/2018 12 p.m. EDT",12405,12670,10425,-1980
ISNE,"5/2/2018 1 p.m. EDT",12527,12960,10821,-1706
ISNE,"5/2/2018 2 p.m. EDT",12824,13250,11027,-1797
ISNE,"5/2/2018 3 p.m. EDT",13105,13400,11395,-1710
ISNE,"5/2/2018 4 p.m. EDT",13504,13730,11656,-1848
ISNE,"5/2/2018 5 p.m. EDT",14038,14190,12084,-1954
ISNE,"5/2/2018 6 p.m. EDT",14459,14470,12468,-1991
ISNE,"5/2/2018 7 p.m. EDT",14593,14690,12413,-2180
ISNE,"5/2/2018 8 p.m. EDT",14738,14770,12529,-2209
ISNE,"5/2/2018 9 p.m. EDT",14958,15000,12911,-2047
ISNE,"5/2/2018 10 p.m. EDT",14082,14080,12124,-1958
ISNE,"5/2/2018 11 p.m. EDT",12679,12570,10585,-2094
ISNE,"5/3/2018 12 a.m. EDT",11534,11260,9589,-1945
ISNE,"5/3/2018 1 a.m. EDT",10909,10470,8778,-2131
ISNE,"5/3/2018 2 a.m. EDT",10480,9930,8421,-2059
ISNE,"5/3/2018 3 a.m. EDT",10231,9620,8100,-2131
ISNE,"5/3/2018 4 a.m. EDT",10272,9510,8033,-2239
ISNE,"5/3/2018 5 a.m. EDT",10244,9720,7956,-2288
ISNE,"5/3/2018 6 a.m. EDT",10808,10560,8777,-2031
ISNE,"5/3/2018 7 a.m. EDT",12216,11990,10450,-1766
ISNE,"5/3/2018 8 a.m. EDT",13220,12970,11533,-1687
ISNE,"5/3/2018 9 a.m. EDT",13468,13230,11717,-1751
ISNE,"5/3/2018 10 a.m. EDT",13296,13270,11514,-1782
ISNE,"5/3/2018 11 a.m. EDT",13792,13530,12098,-1694
ISNE,"5/3/2018 12 p.m. EDT",14358,13930,12699,-1659
ISNE,"5/3/2018 1 p.m. EDT",14880,14210,13248,-1632
ISNE,"5/3/2018 2 p.m. EDT",15341,14760,13692,-1649
ISNE,"5/3/2018 3 p.m. EDT",15546,14940,13833,-1713
ISNE,"5/3/2018 4 p.m. EDT",15679,15130,14078,-1601
ISNE,"5/3/2018 5 p.m. EDT",15825,15360,14160,-1665
ISNE,"5/3/2018 6 p.m. EDT",15887,15600,14134,-1753
ISNE,"5/3/2018 7 p.m. EDT",15866,15770,14252,-1614
ISNE,"5/3/2018 8 p.m. EDT",15976,15700,14228,-1748
ISNE,"5/3/2018 9 p.m. EDT",15845,16000,14228,-1617
ISNE,"5/3/2018 10 p.m. EDT",14986,15090,13192,-1794
ISNE,"5/3/2018 11 p.m. EDT",13590,13660,11649,-1941
ISNE,"5/4/2018 12 a.m. EDT",12373,12390,10397,-1976
ISNE,"5/4/2018 1 a.m. EDT",11666,11350,9702,-1964
ISNE,"5/4/2018 2 a.m. EDT",11170,10790,9237,-1933
ISNE,"5/4/2018 3 a.m. EDT",11172,10460,9175,-1997
ISNE,"5/4/2018 4 a.m. EDT",11309,10330,9254,-2055
ISNE,"5/4/2018 5 a.m. EDT",11542,10500,9571,-1971
ISNE,"5/4/2018 6 a.m. EDT",11842,11310,10121,-1721
ISNE,"5/4/2018 7 a.m. EDT",13053,12790,11703,-1350
ISNE,"5/4/2018 8 a.m. EDT",13888,13910,12482,-1406
ISNE,"5/4/2018 9 a.m. EDT",14321,14340,12928,-1393
ISNE,"5/4/2018 10 a.m. EDT",14530,14530,13005,-1525
ISNE,"5/4/2018 11 a.m. EDT",14658,14690,13115,-1543
ISNE,"5/4/2018 12 p.m. EDT",14797,14790,13191,-1606
ISNE,"5/4/2018 1 p.m. EDT",14789,14660,13392,-1397
ISNE,"5/4/2018 2 p.m. EDT",14605,14630,13168,-1437
ISNE,"5/4/2018 3 p.m. EDT",14802,14780,13512,-1290
ISNE,"5/4/2018 4 p.m. EDT",15177,14850,13799,-1378
ISNE,"5/4/2018 5 p.m. EDT",15492,14850,14034,-1458
ISNE,"5/4/2018 6 p.m. EDT",15477,14880,13785,-1692
ISNE,"5/4/2018 7 p.m. EDT",15327,15050,13612,-1715
ISNE,"5/4/2018 8 p.m. EDT",15334,14540,13308,-2026
ISNE,"5/4/2018 9 p.m. EDT",15354,14480,13499,-1855
ISNE,"5/4/2018 10 p.m. EDT",14551,14000,12696,-1855
ISNE,"5/4/2018 11 p.m. EDT",13249,12900,11437,-1812
ISNE,"5/5/2018 12 a.m. EDT",12152,11800,10379,-1773
ISNE,"5/5/2018 1 a.m. EDT",11077,11010,9133,-1944
ISNE,"5/5/2018 2 a.m. EDT",10610,10330,8527,-2083
ISNE,"5/5/2018 3 a.m. EDT",10299,9840,8209,-2090
ISNE,"5/5/2018 4 a.m. EDT",10260,9530,8139,-2121
ISNE,"5/5/2018 5 a.m. EDT",10206,9400,8083,-2123
ISNE,"5/5/2018 6 a.m. EDT",10318,9520,8352,-1966
ISNE,"5/5/2018 7 a.m. EDT",10660,9870,8649,-2011
ISNE,"5/5/2018 8 a.m. EDT",11203,10460,9130,-2073
ISNE,"5/5/2018 9 a.m. EDT",11185,10910,9283,-1902
ISNE,"5/5/2018 10 a.m. EDT",11214,11000,9427,-1787
ISNE,"5/5/2018 11 a.m. EDT",11118,10990,9468,-1650
ISNE,"5/5/2018 12 p.m. EDT",11057,10980,9616,-1441
ISNE,"5/5/2018 1 p.m. EDT",10886,10960,9539,-1347
ISNE,"5/5/2018 2 p.m. EDT",11202,11030,9687,-1515
ISNE,"5/5/2018 3 p.m. EDT",11073,11140,9606,-1467
ISNE,"5/5/2018 4 p.m. EDT",11268,11400,9969,-1299
ISNE,"5/5/2018 5 p.m. EDT",11848,11600,10506,-1342
ISNE,"5/5/2018 6 p.m. EDT",12332,11970,10663,-1669
ISNE,"5/5/2018 7 p.m. EDT",12526,12510,10575,-1951
ISNE,"5/5/2018 8 p.m. EDT",12611,12440,10508,-2103
ISNE,"5/5/2018 9 p.m. EDT",12838,12850,10943,-1895
ISNE,"5/5/2018 10 p.m. EDT",12305,12280,10400,-1905
ISNE,"5/5/2018 11 p.m. EDT",11400,11370,9424,-1976
ISNE,"5/6/2018 12 a.m. EDT",10710,10420,8886,-1824
ISNE,"5/6/2018 1 a.m. EDT",10458,9750,8205,-2253
ISNE,"5/6/2018 2 a.m. EDT",10235,9270,7916,-2319
ISNE,"5/6/2018 3 a.m. EDT",10045,9000,8063,-1982
ISNE,"5/6/2018 4 a.m. EDT",9903,8870,8083,-1820
ISNE,"5/6/2018 5 a.m. EDT",9898,8880,7898,-2000
ISNE,"5/6/2018 6 a.m. EDT",9791,9000,7800,-1991
ISNE,"5/6/2018 7 a.m. EDT",10065,9300,8228,-1837
ISNE,"5/6/2018 8 a.m. EDT",10488,9960,8753,-1735
ISNE,"5/6/2018 9 a.m. EDT",11095,10780,9441,-1654
ISNE,"5/6/2018 10 a.m. EDT",11537,11500,10119,-1418
ISNE,"5/6/2018 11 a.m. EDT",11789,11780,10209,-1580
ISNE,"5/6/2018 12 p.m. EDT",11921,11960,10369,-1552
ISNE,"5/6/2018 1 p.m. EDT",12019,11840,10330,-1689
ISNE,"5/6/2018 2 p.m. EDT",11965,11800,10174,-1791
ISNE,"5/6/2018 3 p.m. EDT",11984,11710,10155,-1829
ISNE,"5/6/2018 4 p.m. EDT",12038,11710,10147,-1891
ISNE,"5/6/2018 5 p.m. EDT",12265,11880,10260,-2005
ISNE,"5/6/2018 6 p.m. EDT",12649,12400,10652,-1997
ISNE,"5/6/2018 7 p.m. EDT",12836,12660,10952,-1884
ISNE,"5/6/2018 8 p.m. EDT",12872,12860,11118,-1754
ISNE,"5/6/2018 9 p.m. EDT",12822,12930,11159,-1663
ISNE,"5/6/2018 10 p.m. EDT",12048,12240,10203,-1845
ISNE,"5/6/2018 11 p.m. EDT",11125,11170,9089,-2036
ISNE,"5/7/2018 12 a.m. EDT",10496,10200,8605,-1891
ISNE,"5/7/2018 1 a.m. EDT",9876,9320,8001,-1875
ISNE,"5/7/2018 2 a.m. EDT",9470,8940,7754,-1716
ISNE,"5/7/2018 3 a.m. EDT",9558,8770,8136,-1422
ISNE,"5/7/2018 4 a.m. EDT",9565,8780,8081,-1484
ISNE,"5/7/2018 5 a.m. EDT",9869,9100,8570,-1299
ISNE,"5/7/2018 6 a.m. EDT",10483,10010,9283,-1200
ISNE,"5/7/2018 7 a.m. EDT",11403,11430,9971,-1432
ISNE,"5/7/2018 8 a.m. EDT",12236,12250,10829,-1407
ISNE,"5/7/2018 9 a.m. EDT",12251,12250,10802,-1449
ISNE,"5/7/2018 10 a.m. EDT",12138,12190,10881,-1257
ISNE,"5/7/2018 11 a.m. EDT",12041,12230,10630,-1411
ISNE,"5/7/2018 12 p.m. EDT",12069,12210,10682,-1387
ISNE,"5/7/2018 1 p.m. EDT",12044,12130,10771,-1273
ISNE,"5/7/2018 2 p.m. EDT",12126,12180,10819,-1307
ISNE,"5/7/2018 3 p.m. EDT",12154,12140,10703,-1451
ISNE,"5/7/2018 4 p.m. EDT",12311,12300,11036,-1275
ISNE,"5/7/2018 5 p.m. EDT",12605,12610,11205,-1400
ISNE,"5/7/2018 6 p.m. EDT",13061,13100,11655,-1406
ISNE,"5/7/2018 7 p.m. EDT",13392,13460,11830,-1562
ISNE,"5/7/2018 8 p.m. EDT",13509,13610,11654,-1855
ISNE,"5/7/2018 9 p.m. EDT",13703,13850,11857,-1846
ISNE,"5/7/2018 10 p.m. EDT",12882,12990,10868,-2014
ISNE,"5/7/2018 11 p.m. EDT",11678,11710,9748,-1930
ISNE,"5/8/2018 12 a.m. EDT",10689,10580,8865,-1824
ISNE,"5/8/2018 1 a.m. EDT",10163,9600,7789,-2374
ISNE,"5/8/2018 2 a.m. EDT",9737,9180,7498,-2239
ISNE,"5/8/2018 3 a.m. EDT",9577,8990,7409,-2168
ISNE,"5/8/2018 4 a.m. EDT",9753,8960,7547,-2206
ISNE,"5/8/2018 5 a.m. EDT",9771,9230,7640,-2131
ISNE,"5/8/2018 6 a.m. EDT",10399,10080,8095,-2304
ISNE,"5/8/2018 7 a.m. EDT",11679,11530,9551,-2128
ISNE,"5/8/2018 8 a.m. EDT",12271,12270,10366,-1905
ISNE,"5/8/2018 9 a.m. EDT",12148,12140,10315,-1833
ISNE,"5/8/2018 10 a.m. EDT",11924,11800,10213,-1711
ISNE,"5/8/2018 11 a.m. EDT",11893,11710,10321,-1572
ISNE,"5/8/2018 12 p.m. EDT",11941,11720,10386,-1555
ISNE,"5/8/2018 1 p.m. EDT",12019,11670,10659,-1360
ISNE,"5/8/2018 2 p.m. EDT",12234,11800,11023,-1211
ISNE,"5/8/2018 3 p.m. EDT",12312,11840,11034,-1278
ISNE,"5/8/2018 4 p.m. EDT",12465,12220,11068,-1397
ISNE,"5/8/2018 5 p.m. EDT",12833,13010,11435,-1398
ISNE,"5/8/2018 6 p.m. EDT",13358,13040,11997,-1361
ISNE,"5/8/2018 7 p.m. EDT",13616,13300,12029,-1587
ISNE,"5/8/2018 8 p.m. EDT",13694,13520,11813,-1881
ISNE,"5/8/2018 9 p.m. EDT",13890,13800,12178,-1712
ISNE,"5/8/2018 10 p.m. EDT",13069,13040,11426,-1643
ISNE,"5/8/2018 11 p.m. EDT",11723,11690,10079,-1644
ISNE,"5/9/2018 12 a.m. EDT",10717,10530,8976,-1741
ISNE,"5/9/2018 1 a.m. EDT",10492,9710,8299,-2193
ISNE,"5/9/2018 2 a.m. EDT",10096,9260,7800,-2296
ISNE,"5/9/2018 3 a.m. EDT",10194,9030,7789,-2405
ISNE,"5/9/2018 4 a.m. EDT",10303,9010,7967,-2336
ISNE,"5/9/2018 5 a.m. EDT",10314,9280,7928,-2386
ISNE,"5/9/2018 6 a.m. EDT",10547,10080,8638,-1909
ISNE,"5/9/2018 7 a.m. EDT",11717,11490,9715,-2002
ISNE,"5/9/2018 8 a.m. EDT",12223,12230,10224,-1999
ISNE,"5/9/2018 9 a.m. EDT",12171,12160,10617,-1554
ISNE,"5/9/2018 10 a.m. EDT",12072,12020,10628,-1444
ISNE,"5/9/2018 11 a.m. EDT",12088,11980,10857,-1231
ISNE,"5/9/2018 12 p.m. EDT",12164,11960,11072,-1092
ISNE,"5/9/2018 1 p.m. EDT",12222,12020,10862,-1360
ISNE,"5/9/2018 2 p.m. EDT",12431,12090,11124,-1307
ISNE,"5/9/2018 3 p.m. EDT",12544,12180,11323,-1221
ISNE,"5/9/2018 4 p.m. EDT",12812,12460,11845,-967
ISNE,"5/9/2018 5 p.m. EDT",13200,12860,11974,-1226
ISNE,"5/9/2018 6 p.m. EDT",13517,13030,12117,-1400
ISNE,"5/9/2018 7 p.m. EDT",13685,13330,12124,-1561
ISNE,"5/9/2018 8 p.m. EDT",13722,13470,12085,-1637
ISNE,"5/9/2018 9 p.m. EDT",13919,13790,12106,-1813
ISNE,"5/9/2018 10 p.m. EDT",13111,12950,11294,-1817
ISNE,"5/9/2018 11 p.m. EDT",11876,11620,10020,-1856
ISNE,"5/10/2018 12 a.m. EDT",10984,10440,8743,-2241
ISNE,"5/10/2018 1 a.m. EDT",10298,9810,8457,-1841
ISNE,"5/10/2018 2 a.m. EDT",10029,9420,8066,-1963
ISNE,"5/10/2018 3 a.m. EDT",9849,9220,7825,-2024
ISNE,"5/10/2018 4 a.m. EDT",9810,9190,7958,-1852
ISNE,"5/10/2018 5 a.m. EDT",10073,9470,8058,-2015
ISNE,"5/10/2018 6 a.m. EDT",10794,10340,8607,-2187
ISNE,"5/10/2018 7 a.m. EDT",11844,11870,9728,-2116
ISNE,"5/10/2018 8 a.m. EDT",12542,12670,10652,-1890
ISNE,"5/10/2018 9 a.m. EDT",12642,12820,11083,-1559
ISNE,"5/10/2018 10 a.m. EDT",12438,12420,11073,-1365
ISNE,"5/10/2018 11 a.m. EDT",12169,12340,10628,-1541
ISNE,"5/10/2018 12 p.m. EDT",12124,12320,10681,-1443
ISNE,"5/10/2018 1 p.m. EDT",12240,12280,11188,-1052
ISNE,"5/10/2018 2 p.m. EDT",12554,12360,11396,-1158
ISNE,"5/10/2018 3 p.m. EDT",12800,12380,11536,-1264
ISNE,"5/10/2018 4 p.m. EDT",12989,12630,11473,-1516
ISNE,"5/10/2018 5 p.m. EDT",13061,13070,11351,-1710
ISNE,"5/10/2018 6 p.m. EDT",13293,13280,11615,-1678
ISNE,"5/10/2018 7 p.m. EDT",13469,13520,11788,-1681
ISNE,"5/10/2018 8 p.m. EDT",13599,13680,11727,-1872
ISNE,"5/10/2018 9 p.m. EDT",13799,13900,12205,-1594
ISNE,"5/10/2018 10 p.m. EDT",13080,13100,11938,-1142
ISNE,"5/10/2018 11 p.m. EDT",11869,11800,10581,-1288
ISNE,"5/11/2018 12 a.m. EDT",10915,10650,9521,-1394
ISNE,"5/11/2018 1 a.m. EDT",10121,9860,8638,-1483
ISNE,"5/11/2018 2 a.m. EDT",9959,9430,8454,-1505
ISNE,"5/11/2018 3 a.m. EDT",9976,9210,8238,-1738
ISNE,"5/11/2018 4 a.m. EDT",9858,9170,8224,-1634
ISNE,"5/11/2018 5 a.m. EDT",9909,9410,8231,-1678
ISNE,"5/11/2018 6 a.m. EDT",10574,10140,8588,-1986
ISNE,"5/11/2018 7 a.m. EDT",11519,11520,9771,-1748
ISNE,"5/11/2018 8 a.m. EDT",12297,12310,10761,-1536
ISNE,"5/11/2018 9 a.m. EDT",12330,12340,10790,-1540
ISNE,"5/11/2018 10 a.m. EDT",12267,12250,10671,-1596
ISNE,"5/11/2018 11 a.m. EDT",12194,12170,10748,-1446
ISNE,"5/11/2018 12 p.m. EDT",11880,12030,10422,-1458
ISNE,"5/11/2018 1 p.m. EDT",11626,11950,10146,-1480
ISNE,"5/11/2018 2 p.m. EDT",11689,11890,10241,-1448
ISNE,"5/11/2018 3 p.m. EDT",11729,11780,10260,-1469
ISNE,"5/11/2018 4 p.m. EDT",11964,12010,10539,-1425
ISNE,"5/11/2018 5 p.m. EDT",12418,12200,11019,-1399
ISNE,"5/11/2018 6 p.m. EDT",12791,12430,11301,-1490
ISNE,"5/11/2018 7 p.m. EDT",12855,12680,11122,-1733
ISNE,"5/11/2018 8 p.m. EDT",12871,12830,10833,-2038
ISNE,"5/11/2018 9 p.m. EDT",13075,13150,10890,-2185
ISNE,"5/11/2018 10 p.m. EDT",12513,12650,10538,-1975
ISNE,"5/11/2018 11 p.m. EDT",11501,11590,9431,-2070
ISNE,"5/12/2018 12 a.m. EDT",10823,10570,8665,-2158
ISNE,"5/12/2018 1 a.m. EDT",10101,9600,8122,-1979
ISNE,"5/12/2018 2 a.m. EDT",9697,9150,7546,-2151
ISNE,"5/12/2018 3 a.m. EDT",9428,8880,7352,-2076
ISNE,"5/12/2018 4 a.m. EDT",9331,8790,7368,-1963
ISNE,"5/12/2018 5 a.m. EDT",9401,8870,7194,-2207
ISNE,"5/12/2018 6 a.m. EDT",9647,9120,7280,-2367
ISNE,"5/12/2018 7 a.m. EDT",10143,9630,7771,-2372
ISNE,"5/12/2018 8 a.m. EDT",10914,10400,8267,-2647
ISNE,"5/12/2018 9 a.m. EDT",11298,11250,8724,-2574
ISNE,"5/12/2018 10 a.m. EDT",11770,11800,9014,-2756
ISNE,"5/12/2018 11 a.m. EDT",12048,12080,9229,-2819
ISNE,"5/12/2018 12 p.m. EDT",12088,12200,9053,-3035
ISNE,"5/12/2018 1 p.m. EDT",12031,12020,9141,-2890
ISNE,"5/12/2018 2 p.m. EDT",12003,11960,9441,-2562
ISNE,"5/12/2018 3 p.m. EDT",12065,11850,9485,-2580
ISNE,"5/12/2018 4 p.m. EDT",11921,11790,9414,-2507
ISNE,"5/12/2018 5 p.m. EDT",12057,11920,9506,-2551
ISNE,"5/12/2018 6 p.m. EDT",12336,12260,9580,-2756
ISNE,"5/12/2018 7 p.m. EDT",12420,12280,9779,-2641
ISNE,"5/12/2018 8 p.m. EDT",12441,12520,10028,-2413
ISNE,"5/12/2018 9 p.m. EDT",12465,12550,10033,-2432
ISNE,"5/12/2018 10 p.m. EDT",11977,12110,9827,-2150
ISNE,"5/12/2018 11 p.m. EDT",11114,11250,8686,-2428
ISNE,"5/13/2018 12 a.m. EDT",10452,10370,8003,-2449
ISNE,"5/13/2018 1 a.m. EDT",10008,9480,7604,-2404
ISNE,"5/13/2018 2 a.m. EDT",9875,9070,7388,-2487
ISNE,"5/13/2018 3 a.m. EDT",9635,8830,7067,-2568
ISNE,"5/13/2018 4 a.m. EDT",9531,8730,6997,-2534
ISNE,"5/13/2018 5 a.m. EDT",9574,8790,6877,-2697
ISNE,"5/13/2018 6 a.m. EDT",9737,8990,7093,-2644
ISNE,"5/13/2018 7 a.m. EDT",10098,9240,7312,-2786
ISNE,"5/13/2018 8 a.m. EDT",10696,9870,7840,-2856
ISNE,"5/13/2018 9 a.m. EDT",11157,10450,8236,-2921
ISNE,"5/13/2018 10 a.m. EDT",11321,11110,8414,-2907
ISNE,"5/13/2018 11 a.m. EDT",11152,11210,8336,-2816
ISNE,"5/13/2018 12 p.m. EDT",10999,11210,8284,-2715
ISNE,"5/13/2018 1 p.m. EDT",10683,10910,8135,-2548
ISNE,"5/13/2018 2 p.m. EDT",10514,10760,8231,-2283
ISNE,"5/13/2018 3 p.m. EDT",10390,10770,8345,-2045
ISNE,"5/13/2018 4 p.m. EDT",10218,10940,8210,-2008
ISNE,"5/13/2018 5 p.m. EDT",10596,11040,8397,-2199
ISNE,"5/13/2018 6 p.m. EDT",11216,11440,9160,-2056
ISNE,"5/13/2018 7 p.m. EDT",11813,11570,9422,-2391
ISNE,"5/13/2018 8 p.m. EDT",12201,12450,9923,-2278
ISNE,"5/13/2018 9 p.m. EDT",12577,12510,10279,-2298
ISNE,"5/13/2018 10 p.m. EDT",12049,12150,9490,-2559
ISNE,"5/13/2018 11 p.m. EDT",11169,10970,8380,-2789
ISNE,"5/14/2018 12 a.m. EDT",10347,10180,7707,-2640
ISNE,"5/14/2018 1 a.m. EDT",9847,9280,7424,-2423
ISNE,"5/14/2018 2 a.m. EDT",9471,8920,7172,-2299
ISNE,"5/14/2018 3 a.m. EDT",9537,8780,7056,-2481
ISNE,"5/14/2018 4 a.m. EDT",9610,8780,7154,-2456
ISNE,"5/14/2018 5 a.m. EDT",9627,9100,7486,-2141
ISNE,"5/14/2018 6 a.m. EDT",10190,10020,8383,-1807
ISNE,"5/14/2018 7 a.m. EDT",11526,11740,9733,-1793
ISNE,"5/14/2018 8 a.m. EDT",12592,12700,11321,-1271
ISNE,"5/14/2018 9 a.m. EDT",12739,13120,10918,-1821
ISNE,"5/14/2018 10 a.m. EDT",12692,12730,10573,-2119
ISNE,"5/14/2018 11 a.m. EDT",12689,12630,10930,-1759
ISNE,"5/14/2018 12 p.m. EDT",12567,12630,10721,-1846
ISNE,"5/14/2018 1 p.m. EDT",12198,12270,10231,-1967
ISNE,"5/14/2018 2 p.m. EDT",12233,12370,10460,-1773
ISNE,"5/14/2018 3 p.m. EDT",12306,12360,10686,-1620
ISNE,"5/14/2018 4 p.m. EDT",12567,12680,11039,-1528
ISNE,"5/14/2018 5 p.m. EDT",12754,13130,11236,-1518
ISNE,"5/14/2018 6 p.m. EDT",13384,13550,11883,-1501
ISNE,"5/14/2018 7 p.m. EDT",13740,13800,12142,-1598
ISNE,"5/14/2018 8 p.m. EDT",13838,14010,12141,-1697
ISNE,"5/14/2018 9 p.m. EDT",14020,14150,12094,-1926
ISNE,"5/14/2018 10 p.m. EDT",13243,13310,11367,-1876
ISNE,"5/14/2018 11 p.m. EDT",11878,11950,9673,-2205
ISNE,"5/15/2018 12 a.m. EDT",10645,10800,8442,-2203
ISNE,"5/15/2018 1 a.m. EDT",9944,9870,7744,-2200
ISNE,"5/15/2018 2 a.m. EDT",9696,9450,7646,-2050
ISNE,"5/15/2018 3 a.m. EDT",9454,9220,7373,-2081
ISNE,"5/15/2018 4 a.m. EDT",9644,9150,7394,-2250
ISNE,"5/15/2018 5 a.m. EDT",9855,9430,7634,-2221
ISNE,"5/15/2018 6 a.m. EDT",10504,10260,8497,-2007
ISNE,"5/15/2018 7 a.m. EDT",11873,11640,9556,-2317
ISNE,"5/15/2018 8 a.m. EDT",12754,12690,10660,-2094
ISNE,"5/15/2018 9 a.m. EDT",13118,12990,11420,-1698
ISNE,"5/15/2018 10 a.m. EDT",13260,13150,11653,-1607
ISNE,"5/15/2018 11 a.m. EDT",13366,13320,11679,-1687
ISNE,"5/15/2018 12 p.m. EDT",13458,13530,11871,-1587
ISNE,"5/15/2018 1 p.m. EDT",13604,13560,11915,-1689
ISNE,"5/15/2018 2 p.m. EDT",13869,13780,12265,-1604
ISNE,"5/15/2018 3 p.m. EDT",14160,13900,12455,-1705
ISNE,"5/15/2018 4 p.m. EDT",15048,14080,13433,-1615
ISNE,"5/15/2018 5 p.m. EDT",15792,14390,14186,-1606
ISNE,"5/15/2018 6 p.m. EDT",15639,14770,13580,-2059
ISNE,"5/15/2018 7 p.m. EDT",15270,14930,13374,-1896
ISNE,"5/15/2018 8 p.m. EDT",14723,15150,13077,-1646
ISNE,"5/15/2018 9 p.m. EDT",14296,14800,12745,-1551
ISNE,"5/15/2018 10 p.m. EDT",13404,13730,12039,-1365
ISNE,"5/15/2018 11 p.m. EDT",12061,12350,10836,-1225
ISNE,"5/16/2018 12 a.m. EDT",10868,11130,9047,-1821
ISNE,"5/16/2018 1 a.m. EDT",10336,10120,8049,-2287
ISNE,"5/16/2018 2 a.m. EDT",10122,9650,7712,-2410
ISNE,"5/16/2018 3 a.m. EDT",10188,9340,7659,-2529
ISNE,"5/16/2018 4 a.m. EDT",10234,9290,7551,-2683
ISNE,"5/16/2018 5 a.m. EDT",10441,9520,7654,-2787
ISNE,"5/16/2018 6 a.m. EDT",10685,10200,8169,-2516
ISNE,"5/16/2018 7 a.m. EDT",11950,11710,9215,-2735
ISNE,"5/16/2018 8 a.m. EDT",12376,12570,10175,-2201
ISNE,"5/16/2018 9 a.m. EDT",12306,12720,10547,-1759
ISNE,"5/16/2018 10 a.m. EDT",12282,12220,10584,-1698
ISNE,"5/16/2018 11 a.m. EDT",12287,12160,10641,-1646
ISNE,"5/16/2018 12 p.m. EDT",12228,11990,10514,-1714
ISNE,"5/16/2018 1 p.m. EDT",12353,11950,10566,-1787
ISNE,"5/16/2018 2 p.m. EDT",12601,11940,10939,-1662
ISNE,"5/16/2018 3 p.m. EDT",12713,12150,10984,-1729
ISNE,"5/16/2018 4 p.m. EDT",12838,12550,11093,-1745
ISNE,"5/16/2018 5 p.m. EDT",13023,13000,11158,-1865
ISNE,"5/16/2018 6 p.m. EDT",13257,13280,11407,-1850
ISNE,"5/16/2018 7 p.m. EDT",13393,13620,11623,-1770
ISNE,"5/16/2018 8 p.m. EDT",13491,13780,11803,-1688
ISNE,"5/16/2018 9 p.m. EDT",13606,13800,12011,-1595
ISNE,"5/16/2018 10 p.m. EDT",12849,12990,11192,-1657
ISNE,"5/16/2018 11 p.m. EDT",11614,11760,9831,-1783
ISNE,"5/17/2018 12 a.m. EDT",10783,10640,8789,-1994
ISNE,"5/17/2018 1 a.m. EDT",10204,9700,8173,-2031
ISNE,"5/17/2018 2 a.m. EDT",9847,9300,7670,-2177
ISNE,"5/17/2018 3 a.m. EDT",9635,9080,7384,-2251
ISNE,"5/17/2018 4 a.m. EDT",10007,9070,7494,-2513
ISNE,"5/17/2018 5 a.m. EDT",10138,9340,7692,-2446
ISNE,"5/17/2018 6 a.m. EDT",10527,10160,8306,-2221
ISNE,"5/17/2018 7 a.m. EDT",11707,11620,9790,-1917
ISNE,"5/17/2018 8 a.m. EDT",12677,12690,11233,-1444
ISNE,"5/17/2018 9 a.m. EDT",13031,13030,11675,-1356
ISNE,"5/17/2018 10 a.m. EDT",13192,13260,11682,-1510
ISNE,"5/17/2018 11 a.m. EDT",13153,13250,11534,-1619
ISNE,"5/17/2018 12 p.m. EDT",13248,13270,11901,-1347
ISNE,"5/17/2018 1 p.m. EDT",13144,13190,11646,-1498
ISNE,"5/17/2018 2 p.m. EDT",13082,13170,11565,-1517
ISNE,"5/17/2018 3 p.m. EDT",13012,13160,11463,-1549
ISNE,"5/17/2018 4 p.m. EDT",13216,13370,11657,-1559
ISNE,"5/17/2018 5 p.m. EDT",13570,13620,12094,-1476
ISNE,"5/17/2018 6 p.m. EDT",13833,13860,12414,-1419
ISNE,"5/17/2018 7 p.m. EDT",13925,13950,12440,-1485
ISNE,"5/17/2018 8 p.m. EDT",14027,14180,12555,-1472
ISNE,"5/17/2018 9 p.m. EDT",14227,14340,12685,-1542
ISNE,"5/17/2018 10 p.m. EDT",13550,13480,12005,-1545
ISNE,"5/17/2018 11 p.m. EDT",12228,12170,10327,-1901
ISNE,"5/18/2018 12 a.m. EDT",11149,10980,9025,-2124
ISNE,"5/18/2018 1 a.m. EDT",10707,10150,8331,-2376
ISNE,"5/18/2018 2 a.m. EDT",10385,9640,8054,-2331
ISNE,"5/18/2018 3 a.m. EDT",10391,9330,7876,-2515
ISNE,"5/18/2018 4 a.m. EDT",10265,9190,7767,-2498
ISNE,"5/18/2018 5 a.m. EDT",10322,9390,7865,-2457
ISNE,"5/18/2018 6 a.m. EDT",10495,10050,8119,-2376
ISNE,"5/18/2018 7 a.m. EDT",11303,11340,8848,-2455
ISNE,"5/18/2018 8 a.m. EDT",12152,12150,10023,-2129
ISNE,"5/18/2018 9 a.m. EDT",12274,12280,10518,-1756
ISNE,"5/18/2018 10 a.m. EDT",12150,12240,10372,-1778
ISNE,"5/18/2018 11 a.m. EDT",11968,12290,10601,-1367
ISNE,"5/18/2018 12 p.m. EDT",11903,12220,10432,-1471
ISNE,"5/18/2018 1 p.m. EDT",11785,12100,10193,-1592
ISNE,"5/18/2018 2 p.m. EDT",11767,12190,10121,-1646
ISNE,"5/18/2018 3 p.m. EDT",11828,12240,10237,-1591
ISNE,"5/18/2018 4 p.m. EDT",12009,12430,10303,-1706
ISNE,"5/18/2018 5 p.m. EDT",12188,12620,10483,-1705
ISNE,"5/18/2018 6 p.m. EDT",12294,12970,10595,-1699
ISNE,"5/18/2018 7 p.m. EDT",12440,12940,10666,-1774
ISNE,"5/18/2018 8 p.m. EDT",12566,12970,10550,-2016
ISNE,"5/18/2018 9 p.m. EDT",12812,13060,10805,-2007
ISNE,"5/18/2018 10 p.m. EDT",12357,12680,10415,-1942
ISNE,"5/18/2018 11 p.m. EDT",11400,11670,9610,-1790
ISNE,"5/19/2018 12 a.m. EDT",10597,10600,8550,-2047
ISNE,"5/19/2018 1 a.m. EDT",9755,9580,7665,-2090
ISNE,"5/19/2018 2 a.m. EDT",9440,9120,7216,-2224
ISNE,"5/19/2018 3 a.m. EDT",9427,8890,7196,-2231
ISNE,"5/19/2018 4 a.m. EDT",9354,8820,7221,-2133
ISNE,"5/19/2018 5 a.m. EDT",9467,8940,7401,-2066
ISNE,"5/19/2018 6 a.m. EDT",9737,9210,7516,-2221
ISNE,"5/19/2018 7 a.m. EDT",10202,9680,7921,-2281
ISNE,"5/19/2018 8 a.m. EDT",10468,10210,8204,-2264
ISNE,"5/19/2018 9 a.m. EDT",10816,10820,8781,-2035
ISNE,"5/19/2018 10 a.m. EDT",11290,11210,9319,-1971
ISNE,"5/19/2018 11 a.m. EDT",11671,11500,9687,-1984
ISNE,"5/19/2018 12 p.m. EDT",11862,11760,9911,-1951
ISNE,"5/19/2018 1 p.m. EDT",11947,11710,10172,-1775
ISNE,"5/19/2018 2 p.m. EDT",11998,11690,10071,-1927
ISNE,"5/19/2018 3 p.m. EDT",11947,11710,9912,-2035
ISNE,"5/19/2018 4 p.m. EDT",12018,11820,10018,-2000
ISNE,"5/19/2018 5 p.m. EDT",12238,12040,10332,-1906
ISNE,"5/19/2018 6 p.m. EDT",12519,12410,10364,-2155
ISNE,"5/19/2018 7 p.m. EDT",12565,12400,10365,-2200
ISNE,"5/19/2018 8 p.m. EDT",12553,12520,10168,-2385
ISNE,"5/19/2018 9 p.m. EDT",12514,12510,10410,-2104
ISNE,"5/19/2018 10 p.m. EDT",11995,12120,10510,-1485
ISNE,"5/19/2018 11 p.m. EDT",11157,11230,9831,-1326
ISNE,"5/20/2018 12 a.m. EDT",10240,10340,8184,-2056
ISNE,"5/20/2018 1 a.m. EDT",9680,9540,7634,-2046
ISNE,"5/20/2018 2 a.m. EDT",9522,9120,7428,-2094
ISNE,"5/20/2018 3 a.m. EDT",9733,8890,7606,-2127
ISNE,"5/20/2018 4 a.m. EDT",9886,8810,7861,-2025
ISNE,"5/20/2018 5 a.m. EDT",9942,8890,7778,-2164
ISNE,"5/20/2018 6 a.m. EDT",9952,9020,7802,-2150
ISNE,"5/20/2018 7 a.m. EDT",10194,9420,8216,-1978
ISNE,"5/20/2018 8 a.m. EDT",10612,10100,8729,-1883
ISNE,"5/20/2018 9 a.m. EDT",11306,10900,9520,-1786
ISNE,"5/20/2018 10 a.m. EDT",11751,11580,9736,-2015
ISNE,"5/20/2018 11 a.m. EDT",11972,11820,9813,-2159
ISNE,"5/20/2018 12 p.m. EDT",11974,12020,9966,-2008
ISNE,"5/20/2018 1 p.m. EDT",12348,12160,10463,-1885
ISNE,"5/20/2018 2 p.m. EDT",12286,12280,10363,-1923
ISNE,"5/20/2018 3 p.m. EDT",12385,12430,10516,-1869
ISNE,"5/20/2018 4 p.m. EDT",12557,12610,10797,-1760
ISNE,"5/20/2018 5 p.m. EDT",12927,12890,11267,-1660
ISNE,"5/20/2018 6 p.m. EDT",13426,13380,11805,-1621
ISNE,"5/20/2018 7 p.m. EDT",13628,13590,11828,-1800
ISNE,"5/20/2018 8 p.m. EDT",13619,13780,11681,-1938
ISNE,"5/20/2018 9 p.m. EDT",13726,13980,12091,-1635
ISNE,"5/20/2018 10 p.m. EDT",13118,13140,11554,-1564
ISNE,"5/20/2018 11 p.m. EDT",11869,11940,10044,-1825
ISNE,"5/21/2018 12 a.m. EDT",10666,10800,8776,-1890
ISNE,"5/21/2018 1 a.m. EDT",10072,9780,8237,-1835
ISNE,"5/21/2018 2 a.m. EDT",10011,9310,7926,-2085
ISNE,"5/21/2018 3 a.m. EDT",10131,9060,7985,-2146
ISNE,"5/21/2018 4 a.m. EDT",10044,8990,7943,-2101
ISNE,"5/21/2018 5 a.m. EDT",9987,9220,8098,-1889
ISNE,"5/21/2018 6 a.m. EDT",10740,9980,9078,-1662
ISNE,"5/21/2018 7 a.m. EDT",11730,11400,10229,-1501
ISNE,"5/21/2018 8 a.m. EDT",12202,12200,10869,-1333
ISNE,"5/21/2018 9 a.m. EDT",12237,12230,11273,-964
ISNE,"5/21/2018 10 a.m. EDT",12207,12240,11377,-830
ISNE,"5/21/2018 11 a.m. EDT",12266,12350,11239,-1027
ISNE,"5/21/2018 12 p.m. EDT",12369,12410,11415,-954
ISNE,"5/21/2018 1 p.m. EDT",12432,12760,11630,-802
ISNE,"5/21/2018 2 p.m. EDT",12660,12980,11818,-842
ISNE,"5/21/2018 3 p.m. EDT",12848,13210,11975,-873
ISNE,"5/21/2018 4 p.m. EDT",13135,13600,12012,-1123
ISNE,"5/21/2018 5 p.m. EDT",13640,13720,12541,-1099
ISNE,"5/21/2018 6 p.m. EDT",14273,14310,13205,-1068
ISNE,"5/21/2018 7 p.m. EDT",14572,14550,13227,-1345
ISNE,"5/21/2018 8 p.m. EDT",14472,14550,13098,-1374
ISNE,"5/21/2018 9 p.m. EDT",14479,14720,13123,-1356
ISNE,"5/21/2018 10 p.m. EDT",13684,13620,12226,-1458
ISNE,"5/21/2018 11 p.m. EDT",12279,12080,10548,-1731
ISNE,"5/22/2018 12 a.m. EDT",11036,10640,9362,-1674
ISNE,"5/22/2018 1 a.m. EDT",10243,10350,8354,-1889
ISNE,"5/22/2018 2 a.m. EDT",9805,9830,8123,-1682
ISNE,"5/22/2018 3 a.m. EDT",9525,9590,8025,-1500
ISNE,"5/22/2018 4 a.m. EDT",9426,9500,7985,-1441
ISNE,"5/22/2018 5 a.m. EDT",9673,9710,8119,-1554
ISNE,"5/22/2018 6 a.m. EDT",10160,10490,8346,-1814
ISNE,"5/22/2018 7 a.m. EDT",11407,12050,9586,-1821
ISNE,"5/22/2018 8 a.m. EDT",12499,13080,11274,-1225
ISNE,"5/22/2018 9 a.m. EDT",12974,13160,11785,-1189
ISNE,"5/22/2018 10 a.m. EDT",13275,13330,12199,-1076
ISNE,"5/22/2018 11 a.m. EDT",13565,13480,12557,-1008
ISNE,"5/22/2018 12 p.m. EDT",13648,13640,12391,-1257
ISNE,"5/22/2018 1 p.m. EDT",13733,13690,12479,-1254
ISNE,"5/22/2018 2 p.m. EDT",13820,13690,12610,-1210
ISNE,"5/22/2018 3 p.m. EDT",13678,13700,12476,-1202
ISNE,"5/22/2018 4 p.m. EDT",13648,13810,12444,-1204
ISNE,"5/22/2018 5 p.m. EDT",13813,13930,12628,-1185
ISNE,"5/22/2018 6 p.m. EDT",14008,14080,12668,-1340
ISNE,"5/22/2018 7 p.m. EDT",13973,14140,12581,-1392
ISNE,"5/22/2018 8 p.m. EDT",13856,14090,12700,-1156
ISNE,"5/22/2018 9 p.m. EDT",13705,13960,12926,-779
ISNE,"5/22/2018 10 p.m. EDT",12893,13300,12067,-826
ISNE,"5/22/2018 11 p.m. EDT",11630,11940,10261,-1369
ISNE,"5/23/2018 12 a.m. EDT",10681,10780,8709,-1972
ISNE,"5/23/2018 1 a.m. EDT",10287,9970,8273,-2014
ISNE,"5/23/2018 2 a.m. EDT",10123,9570,8320,-1803
ISNE,"5/23/2018 3 a.m. EDT",9937,9410,8067,-1870
ISNE,"5/23/2018 4 a.m. EDT",9881,9250,8051,-1830
ISNE,"5/23/2018 5 a.m. EDT",10145,9600,8229,-1916
ISNE,"5/23/2018 6 a.m. EDT",10447,10320,8769,-1678
ISNE,"5/23/2018 7 a.m. EDT",11578,11830,9912,-1666
ISNE,"5/23/2018 8 a.m. EDT",12567,12810,11149,-1418
ISNE,"5/23/2018 9 a.m. EDT",12652,13050,11526,-1126
ISNE,"5/23/2018 10 a.m. EDT",12655,12700,11549,-1106
ISNE,"5/23/2018 11 a.m. EDT",12777,12950,11739,-1038
ISNE,"5/23/2018 12 p.m. EDT",12849,13220,11855,-994
ISNE,"5/23/2018 1 p.m. EDT",12878,13240,11838,-1040
ISNE,"5/23/2018 2 p.m. EDT",13188,13680,12164,-1024
ISNE,"5/23/2018 3 p.m. EDT",13538,13920,12598,-940
ISNE,"5/23/2018 4 p.m. EDT",13982,14450,12815,-1167
ISNE,"5/23/2018 5 p.m. EDT",14506,14950,13373,-1133
ISNE,"5/23/2018 6 p.m. EDT",14998,15100,13861,-1137
ISNE,"5/23/2018 7 p.m. EDT",15170,15140,13880,-1290
ISNE,"5/23/2018 8 p.m. EDT",15128,14940,13740,-1388
ISNE,"5/23/2018 9 p.m. EDT",15137,14970,13761,-1376
ISNE,"5/23/2018 10 p.m. EDT",14330,13980,12895,-1435
ISNE,"5/23/2018 11 p.m. EDT",12869,12440,11111,-1758
ISNE,"5/24/2018 12 a.m. EDT",11457,11040,9444,-2013
ISNE,"5/24/2018 1 a.m. EDT",10718,10420,8884,-1834
ISNE,"5/24/2018 2 a.m. EDT",10368,9830,8705,-1663
ISNE,"5/24/2018 3 a.m. EDT",10299,9500,8647,-1652
ISNE,"5/24/2018 4 a.m. EDT",10204,9370,8599,-1605
ISNE,"5/24/2018 5 a.m. EDT",10399,9580,8706,-1693
ISNE,"5/24/2018 6 a.m. EDT",10585,10330,8934,-1651
ISNE,"5/24/2018 7 a.m. EDT",11664,11650,9961,-1703
ISNE,"5/24/2018 8 a.m. EDT",12578,12500,11180,-1398
ISNE,"5/24/2018 9 a.m. EDT",12743,12490,11615,-1128
ISNE,"5/24/2018 10 a.m. EDT",12648,12470,11632,-1016
ISNE,"5/24/2018 11 a.m. EDT",12576,12470,11701,-875
ISNE,"5/24/2018 12 p.m. EDT",12593,12410,11770,-823
ISNE,"5/24/2018 1 p.m. EDT",12625,12570,11911,-714
ISNE,"5/24/2018 2 p.m. EDT",12816,12800,11943,-873
ISNE,"5/24/2018 3 p.m. EDT",12945,12960,12063,-882
ISNE,"5/24/2018 4 p.m. EDT",13285,13040,12657,-628
ISNE,"5/24/2018 5 p.m. EDT",13782,13220,13195,-587
ISNE,"5/24/2018 6 p.m. EDT",14259,13480,13636,-623
ISNE,"5/24/2018 7 p.m. EDT",14414,13610,13754,-660
ISNE,"5/24/2018 8 p.m. EDT",14332,13760,13497,-835
ISNE,"5/24/2018 9 p.m. EDT",14300,13940,13250,-1050
ISNE,"5/24/2018 10 p.m. EDT",13656,13140,12830,-826
ISNE,"5/24/2018 11 p.m. EDT",12270,11860,10715,-1555
ISNE,"5/25/2018 12 a.m. EDT",11291,10720,9159,-2132
ISNE,"5/25/2018 1 a.m. EDT",10909,10000,9039,-1870
ISNE,"5/25/2018 2 a.m. EDT",10656,9760,8773,-1883
ISNE,"5/25/2018 3 a.m. EDT",10362,9230,8323,-2039
ISNE,"5/25/2018 4 a.m. EDT",10266,9310,8294,-1972
ISNE,"5/25/2018 5 a.m. EDT",10496,9490,8605,-1891
ISNE,"5/25/2018 6 a.m. EDT",10689,10230,9006,-1683
ISNE,"5/25/2018 7 a.m. EDT",11867,11610,10165,-1702
ISNE,"5/25/2018 8 a.m. EDT",12906,12790,11170,-1736
ISNE,"5/25/2018 9 a.m. EDT",13052,12850,11484,-1568
ISNE,"5/25/2018 10 a.m. EDT",12930,12950,11908,-1022
ISNE,"5/25/2018 11 a.m. EDT",13277,13390,12511,-766
ISNE,"5/25/2018 12 p.m. EDT",13877,13820,12936,-941
ISNE,"5/25/2018 1 p.m. EDT",14077,14130,13098,-979
ISNE,"5/25/2018 2 p.m. EDT",14270,14410,13260,-1010
ISNE,"5/25/2018 3 p.m. EDT",14628,15020,13500,-1128
ISNE,"5/25/2018 4 p.m. EDT",15079,15380,13913,-1166
ISNE,"5/25/2018 5 p.m. EDT",15564,15570,14173,-1391
ISNE,"5/25/2018 6 p.m. EDT",15875,15700,14397,-1478
ISNE,"5/25/2018 7 p.m. EDT",15825,15460,14084,-1741
ISNE,"5/25/2018 8 p.m. EDT",15507,15610,13900,-1607
ISNE,"5/25/2018 9 p.m. EDT",15461,15800,13989,-1472
ISNE,"5/25/2018 10 p.m. EDT",14880,15050,13366,-1514
ISNE,"5/25/2018 11 p.m. EDT",13696,13780,12384,-1312
ISNE,"5/26/2018 12 a.m. EDT",12423,12420,10865,-1558
ISNE,"5/26/2018 1 a.m. EDT",11413,11330,9704,-1709
ISNE,"5/26/2018 2 a.m. EDT",10739,10800,8956,-1783
ISNE,"5/26/2018 3 a.m. EDT",10535,10170,8726,-1809
ISNE,"5/26/2018 4 a.m. EDT",10679,10080,8736,-1943
ISNE,"5/26/2018 5 a.m. EDT",10656,10190,8727,-1929
ISNE,"5/26/2018 6 a.m. EDT",10728,10180,8813,-1915
ISNE,"5/26/2018 7 a.m. EDT",11208,11020,8983,-2225
ISNE,"5/26/2018 8 a.m. EDT",11778,11900,9805,-1973
ISNE,"5/26/2018 9 a.m. EDT",12468,12730,10709,-1759
ISNE,"5/26/2018 10 a.m. EDT",13245,13130,11829,-1416
ISNE,"5/26/2018 11 a.m. EDT",13927,13650,12793,-1134
ISNE,"5/26/2018 12 p.m. EDT",14312,14190,13136,-1176
ISNE,"5/26/2018 1 p.m. EDT",14545,14330,13202,-1343
ISNE,"5/26/2018 2 p.m. EDT",14847,14900,13541,-1306
ISNE,"5/26/2018 3 p.m. EDT",15195,15090,14098,-1097
ISNE,"5/26/2018 4 p.m. EDT",15452,15480,14167,-1285
ISNE,"5/26/2018 5 p.m. EDT",15833,15640,14604,-1229
ISNE,"5/26/2018 6 p.m. EDT",16069,15940,14562,-1507
ISNE,"5/26/2018 7 p.m. EDT",15925,15980,14113,-1812
ISNE,"5/26/2018 8 p.m. EDT",15546,15790,13892,-1654
ISNE,"5/26/2018 9 p.m. EDT",15424,15580,13674,-1750
ISNE,"5/26/2018 10 p.m. EDT",14806,14800,13074,-1732
ISNE,"5/26/2018 11 p.m. EDT",13710,13850,11825,-1885
ISNE,"5/27/2018 12 a.m. EDT",12496,12560,10515,-1981
ISNE,"5/27/2018 1 a.m. EDT",11527,11090,9963,-1564
ISNE,"5/27/2018 2 a.m. EDT",10848,10490,9381,-1467
ISNE,"5/27/2018 3 a.m. EDT",10410,10040,8722,-1688
ISNE,"5/27/2018 4 a.m. EDT",10277,10050,8472,-1805
ISNE,"5/27/2018 5 a.m. EDT",10099,9830,8465,-1634
ISNE,"5/27/2018 6 a.m. EDT",10108,9840,8358,-1750
ISNE,"5/27/2018 7 a.m. EDT",10551,10020,8335,-2216
ISNE,"5/27/2018 8 a.m. EDT",11004,10440,8666,-2338
ISNE,"5/27/2018 9 a.m. EDT",11295,11100,8978,-2317
ISNE,"5/27/2018 10 a.m. EDT",11677,11680,9782,-1895
ISNE,"5/27/2018 11 a.m. EDT",11967,11870,9974,-1993
ISNE,"5/27/2018 12 p.m. EDT",12071,12040,10127,-1944
ISNE,"5/27/2018 1 p.m. EDT",12084,12020,10059,-2025
ISNE,"5/27/2018 2 p.m. EDT",11988,11940,9914,-2074
ISNE,"5/27/2018 3 p.m. EDT",11847,11870,9748,-2099
ISNE,"5/27/2018 4 p.m. EDT",11707,11880,9807,-1900
ISNE,"5/27/2018 5 p.m. EDT",12105,11980,9931,-2174
ISNE,"5/27/2018 6 p.m. EDT",12344,12490,10189,-2155
ISNE,"5/27/2018 7 p.m. EDT",12169,12750,9924,-2245
ISNE,"5/27/2018 8 p.m. EDT",12160,12710,10008,-2152
ISNE,"5/27/2018 9 p.m. EDT",12154,12520,10083,-2071
ISNE,"5/27/2018 10 p.m. EDT",11687,12230,9533,-2154
ISNE,"5/27/2018 11 p.m. EDT",10932,11120,8715,-2217
ISNE,"5/28/2018 12 a.m. EDT",10521,10230,7917,-2604
ISNE,"5/28/2018 1 a.m. EDT",9935,9400,7476,-2459
ISNE,"5/28/2018 2 a.m. EDT",9781,8970,7435,-2346
ISNE,"5/28/2018 3 a.m. EDT",9544,8740,7297,-2247
ISNE,"5/28/2018 4 a.m. EDT",9740,8680,7284,-2456
ISNE,"5/28/2018 5 a.m. EDT",9827,8760,7109,-2718
ISNE,"5/28/2018 6 a.m. EDT",10051,8980,7467,-2584
ISNE,"5/28/2018 7 a.m. EDT",10111,9400,7668,-2443
ISNE,"5/28/2018 8 a.m. EDT",10507,10040,8047,-2460
ISNE,"5/28/2018 9 a.m. EDT",10806,10800,8862,-1944
ISNE,"5/28/2018 10 a.m. EDT",11437,11400,9470,-1967
ISNE,"5/28/2018 11 a.m. EDT",11854,11790,9801,-2053
ISNE,"5/28/2018 12 p.m. EDT",11767,12020,10223,-1544
ISNE,"5/28/2018 1 p.m. EDT",11658,12030,10256,-1402
ISNE,"5/28/2018 2 p.m. EDT",11644,11980,10009,-1635
ISNE,"5/28/2018 3 p.m. EDT",11468,12140,9934,-1534
ISNE,"5/28/2018 4 p.m. EDT",11362,12150,9932,-1430
ISNE,"5/28/2018 5 p.m. EDT",11766,12410,10302,-1464
ISNE,"5/28/2018 6 p.m. EDT",12318,12880,10819,-1499
ISNE,"5/28/2018 7 p.m. EDT",12670,13000,11112,-1558
ISNE,"5/28/2018 8 p.m. EDT",12876,13150,11306,-1570
ISNE,"5/28/2018 9 p.m. EDT",13074,13400,11560,-1514
ISNE,"5/28/2018 10 p.m. EDT",12537,12620,10825,-1712
ISNE,"5/28/2018 11 p.m. EDT",11385,11330,9512,-1873
ISNE,"5/29/2018 12 a.m. EDT",10371,10220,8295,-2076
ISNE,"5/29/2018 1 a.m. EDT",10171,9570,7758,-2413
ISNE,"5/29/2018 2 a.m. EDT",10268,9180,7701,-2567
ISNE,"5/29/2018 3 a.m. EDT",10056,8990,7258,-2798
ISNE,"5/29/2018 4 a.m. EDT",10022,8970,7311,-2711
ISNE,"5/29/2018 5 a.m. EDT",10256,9310,7911,-2345
ISNE,"5/29/2018 6 a.m. EDT",10595,10140,8595,-2000
ISNE,"5/29/2018 7 a.m. EDT",11741,11680,9767,-1974
ISNE,"5/29/2018 8 a.m. EDT",12781,12790,10799,-1982
ISNE,"5/29/2018 9 a.m. EDT",13076,13090,11122,-1954
ISNE,"5/29/2018 10 a.m. EDT",13353,13350,11582,-1771
ISNE,"5/29/2018 11 a.m. EDT",13792,13870,12350,-1442
ISNE,"5/29/2018 12 p.m. EDT",14262,14340,12871,-1391
ISNE,"5/29/2018 1 p.m. EDT",14733,14720,13776,-957
ISNE,"5/29/2018 2 p.m. EDT",15324,15470,14674,-650
ISNE,"5/29/2018 3 p.m. EDT",15761,15920,15076,-685
ISNE,"5/29/2018 4 p.m. EDT",16212,16510,15382,-830
ISNE,"5/29/2018 5 p.m. EDT",16779,16670,16021,-758
ISNE,"5/29/2018 6 p.m. EDT",17227,16800,16429,-798
ISNE,"5/29/2018 7 p.m. EDT",17367,16560,16154,-1213
ISNE,"5/29/2018 8 p.m. EDT",17112,16360,15765,-1347
ISNE,"5/29/2018 9 p.m. EDT",16835,16170,15552,-1283
ISNE,"5/29/2018 10 p.m. EDT",15934,15400,14649,-1285
ISNE,"5/29/2018 11 p.m. EDT",14220,13860,12483,-1737
ISNE,"5/30/2018 12 a.m. EDT",12598,12510,10334,-2264
ISNE,"5/30/2018 1 a.m. EDT",11514,11420,8842,-2672
ISNE,"5/30/2018 2 a.m. EDT",11118,10810,8544,-2574
ISNE,"5/30/2018 3 a.m. EDT",10690,10390,8292,-2398
ISNE,"5/30/2018 4 a.m. EDT",10701,10190,8191,-2510
ISNE,"5/30/2018 5 a.m. EDT",10797,10310,8311,-2486
ISNE,"5/30/2018 6 a.m. EDT",11240,10970,8803,-2437
ISNE,"5/30/2018 7 a.m. EDT",12322,12340,10470,-1852
ISNE,"5/30/2018 8 a.m. EDT",13221,13210,11559,-1662
ISNE,"5/30/2018 9 a.m. EDT",13471,13470,12133,-1338
ISNE,"5/30/2018 10 a.m. EDT",13620,13610,12596,-1024
ISNE,"5/30/2018 11 a.m. EDT",13829,13830,13096,-733
ISNE,"5/30/2018 12 p.m. EDT",14075,14080,13453,-622
ISNE,"5/30/2018 1 p.m. EDT",14266,14290,13795,-471
ISNE,"5/30/2018 2 p.m. EDT",14604,14600,14208,-396
ISNE,"5/30/2018 3 p.m. EDT",14866,14900,14579,-287
ISNE,"5/30/2018 4 p.m. EDT",15255,15070,15070,-185
ISNE,"5/30/2018 5 p.m. EDT",15616,15390,15404,-212
ISNE,"5/30/2018 6 p.m. EDT",15892,15600,15629,-263
ISNE,"5/30/2018 7 p.m. EDT",15810,15850,15139,-671
ISNE,"5/30/2018 8 p.m. EDT",15474,15450,14269,-1205
ISNE,"5/30/2018 9 p.m. EDT",15318,15200,14340,-978
ISNE,"5/30/2018 10 p.m. EDT",14602,14430,13386,-1216
ISNE,"5/30/2018 11 p.m. EDT",13121,12940,11428,-1693
ISNE,"5/31/2018 12 a.m. EDT",11914,11730,9664,-2250
ISNE,"5/31/2018 1 a.m. EDT",11312,10700,8924,-2388
ISNE,"5/31/2018 2 a.m. EDT",11144,10120,8866,-2278
ISNE,"5/31/2018 3 a.m. EDT",11155,9810,8873,-2282
ISNE,"5/31/2018 4 a.m. EDT",11007,9660,8603,-2404
ISNE,"5/31/2018 5 a.m. EDT",11116,9860,8700,-2416
ISNE,"5/31/2018 6 a.m. EDT",11267,10460,9168,-2099
ISNE,"5/31/2018 7 a.m. EDT",12386,11860,10198,-2188
ISNE,"5/31/2018 8 a.m. EDT",12948,12860,11370,-1578
ISNE,"5/31/2018 9 a.m. EDT",13113,13120,12037,-1076
ISNE,"5/31/2018 10 a.m. EDT",13277,13290,12265,-1012
ISNE,"5/31/2018 11 a.m. EDT",13527,13540,12757,-770
ISNE,"5/31/2018 12 p.m. EDT",13837,13850,13291,-546
ISNE,"5/31/2018 1 p.m. EDT",14133,14150,13714,-419
ISNE,"5/31/2018 2 p.m. EDT",14559,14560,13825,-734
ISNE,"5/31/2018 3 p.m. EDT",14934,14990,14168,-766
ISNE,"5/31/2018 4 p.m. EDT",15402,15320,14645,-757
ISNE,"5/31/2018 5 p.m. EDT",15837,15610,14983,-854
ISNE,"5/31/2018 6 p.m. EDT",16063,15890,14984,-1079
ISNE,"5/31/2018 7 p.m. EDT",16056,15940,14662,-1394
ISNE,"5/31/2018 8 p.m. EDT",15898,15780,14424,-1474
ISNE,"5/31/2018 9 p.m. EDT",15841,15580,14168,-1673
ISNE,"5/31/2018 10 p.m. EDT",15278,14600,13295,-1983
ISNE,"5/31/2018 11 p.m. EDT",15119,13240,14832,-287
ISNE,"6/1/2018 12 a.m. EDT",15119,11980,14844,-275
