"BA Code","Timestamp (Hour Ending)","Demand (MWh)","Demand Forecast (MWh)","Net Generation (MWh)","Total Interchange (MWh)"
ISNE,"7/1/2016 12 a.m. EDT",14447,14040,11998,-2449
ISNE,"7/1/2016 1 a.m. EDT",13183,13020,10806,-2377
ISNE,"7/1/2016 2 a.m. EDT",12581,12320,10586,-1995
ISNE,"7/1/2016 3 a.m. EDT",12556,11810,10536,-2020
ISNE,"7/1/2016 4 a.m. EDT",12549,11550,10407,-2142
ISNE,"7/1/2016 5 a.m. EDT",12632,11660,10472,-2160
ISNE,"7/1/2016 6 a.m. EDT",12576,12190,10558,-2018
ISNE,"7/1/2016 7 a.m. EDT",13329,13600,11389,-1940
ISNE,"7/1/2016 8 a.m. EDT",14782,15100,12912,-1870
ISNE,"7/1/2016 9 a.m. EDT",15939,16150,14068,-1871
ISNE,"7/1/2016 10 a.m. EDT",16902,16860,15053,-1849
ISNE,"7/1/2016 11 a.m. EDT",17762,17520,15733,-2029
ISNE,"7/1/2016 12 p.m. EDT",18366,17890,16118,-2248
ISNE,"7/1/2016 1 p.m. EDT",18659,18270,16210,-2449
ISNE,"7/1/2016 2 p.m. EDT",18932,18630,16229,-2703
ISNE,"7/1/2016 3 p.m. EDT",19037,18790,16245,-2792
ISNE,"7/1/2016 4 p.m. EDT",18941,18850,16090,-2851
ISNE,"7/1/2016 5 p.m. EDT",18861,18810,15918,-2943
ISNE,"7/1/2016 6 p.m. EDT",18697,18570,15660,-3037
ISNE,"7/1/2016 7 p.m. EDT",18228,18050,15126,-3102
ISNE,"7/1/2016 8 p.m. EDT",17697,17480,14620,-3077
ISNE,"7/1/2016 9 p.m. EDT",17382,17210,14337,-3045
ISNE,"7/1/2016 10 p.m. EDT",16781,16700,14056,-2725
ISNE,"7/1/2016 11 p.m. EDT",15422,15380,12748,-2674
ISNE,"7/2/2016 12 a.m. EDT",14059,14150,11231,-2828
ISNE,"7/2/2016 1 a.m. EDT",12977,13130,10464,-2513
ISNE,"7/2/2016 2 a.m. EDT",12611,12330,10273,-2338
ISNE,"7/2/2016 3 a.m. EDT",12552,11780,10082,-2470
ISNE,"7/2/2016 4 a.m. EDT",12487,11430,9738,-2749
ISNE,"7/2/2016 5 a.m. EDT",12369,11310,9651,-2718
ISNE,"7/2/2016 6 a.m. EDT",12307,11250,9669,-2638
ISNE,"7/2/2016 7 a.m. EDT",12612,11640,9775,-2837
ISNE,"7/2/2016 8 a.m. EDT",13174,12580,10557,-2617
ISNE,"7/2/2016 9 a.m. EDT",13256,13590,10924,-2332
ISNE,"7/2/2016 10 a.m. EDT",13794,14240,11404,-2390
ISNE,"7/2/2016 11 a.m. EDT",14146,14670,11600,-2546
ISNE,"7/2/2016 12 p.m. EDT",14542,15020,11633,-2909
ISNE,"7/2/2016 1 p.m. EDT",14442,15140,11594,-2848
ISNE,"7/2/2016 2 p.m. EDT",14444,15200,11558,-2886
ISNE,"7/2/2016 3 p.m. EDT",14550,15300,11815,-2735
ISNE,"7/2/2016 4 p.m. EDT",14397,15350,11928,-2469
ISNE,"7/2/2016 5 p.m. EDT",14565,15560,12205,-2360
ISNE,"7/2/2016 6 p.m. EDT",14816,15720,12417,-2399
ISNE,"7/2/2016 7 p.m. EDT",14863,15560,12429,-2434
ISNE,"7/2/2016 8 p.m. EDT",14531,15160,12241,-2290
ISNE,"7/2/2016 9 p.m. EDT",14218,14990,11872,-2346
ISNE,"7/2/2016 10 p.m. EDT",13938,14640,11586,-2352
ISNE,"7/2/2016 11 p.m. EDT",13048,13640,10986,-2062
ISNE,"7/3/2016 12 a.m. EDT",11986,12490,10165,-1821
ISNE,"7/3/2016 1 a.m. EDT",11336,11140,9492,-1844
ISNE,"7/3/2016 2 a.m. EDT",11032,10600,9243,-1789
ISNE,"7/3/2016 3 a.m. EDT",10902,10190,9155,-1747
ISNE,"7/3/2016 4 a.m. EDT",10788,9930,9341,-1447
ISNE,"7/3/2016 5 a.m. EDT",10691,9860,9180,-1511
ISNE,"7/3/2016 6 a.m. EDT",10598,9620,9204,-1394
ISNE,"7/3/2016 7 a.m. EDT",10806,9940,9553,-1253
ISNE,"7/3/2016 8 a.m. EDT",11519,10670,9989,-1530
ISNE,"7/3/2016 9 a.m. EDT",11845,11610,10434,-1411
ISNE,"7/3/2016 10 a.m. EDT",12317,12390,10687,-1630
ISNE,"7/3/2016 11 a.m. EDT",12850,12950,11318,-1532
ISNE,"7/3/2016 12 p.m. EDT",13303,13380,11693,-1610
ISNE,"7/3/2016 1 p.m. EDT",13629,13750,11673,-1956
ISNE,"7/3/2016 2 p.m. EDT",13860,13900,12076,-1784
ISNE,"7/3/2016 3 p.m. EDT",14102,14130,12317,-1785
ISNE,"7/3/2016 4 p.m. EDT",14393,14420,12310,-2083
ISNE,"7/3/2016 5 p.m. EDT",14779,14890,12577,-2202
ISNE,"7/3/2016 6 p.m. EDT",15042,15340,12561,-2481
ISNE,"7/3/2016 7 p.m. EDT",14934,15750,12489,-2445
ISNE,"7/3/2016 8 p.m. EDT",14572,15210,12359,-2213
ISNE,"7/3/2016 9 p.m. EDT",14342,15010,12364,-1978
ISNE,"7/3/2016 10 p.m. EDT",14167,14590,12130,-2037
ISNE,"7/3/2016 11 p.m. EDT",13441,13500,11229,-2212
ISNE,"7/4/2016 12 a.m. EDT",12469,12340,10115,-2354
ISNE,"7/4/2016 1 a.m. EDT",11523,11170,9700,-1823
ISNE,"7/4/2016 2 a.m. EDT",10863,10530,9528,-1335
ISNE,"7/4/2016 3 a.m. EDT",10416,10170,9277,-1139
ISNE,"7/4/2016 4 a.m. EDT",10168,9980,9113,-1055
ISNE,"7/4/2016 5 a.m. EDT",10101,9890,8903,-1198
ISNE,"7/4/2016 6 a.m. EDT",10352,10150,8936,-1416
ISNE,"7/4/2016 7 a.m. EDT",10867,10570,9398,-1469
ISNE,"7/4/2016 8 a.m. EDT",11832,11590,10386,-1446
ISNE,"7/4/2016 9 a.m. EDT",12547,12560,11033,-1514
ISNE,"7/4/2016 10 a.m. EDT",13348,13450,11639,-1709
ISNE,"7/4/2016 11 a.m. EDT",14130,14150,12542,-1588
ISNE,"7/4/2016 12 p.m. EDT",14736,14750,12871,-1865
ISNE,"7/4/2016 1 p.m. EDT",15227,14970,13287,-1940
ISNE,"7/4/2016 2 p.m. EDT",15541,15010,13490,-2051
ISNE,"7/4/2016 3 p.m. EDT",15858,15380,13854,-2004
ISNE,"7/4/2016 4 p.m. EDT",16300,15670,14343,-1957
ISNE,"7/4/2016 5 p.m. EDT",16824,16300,14776,-2048
ISNE,"7/4/2016 6 p.m. EDT",17187,16740,14992,-2195
ISNE,"7/4/2016 7 p.m. EDT",17000,16950,14630,-2370
ISNE,"7/4/2016 8 p.m. EDT",16452,16310,14092,-2360
ISNE,"7/4/2016 9 p.m. EDT",16157,15850,13893,-2264
ISNE,"7/4/2016 10 p.m. EDT",15674,15400,13576,-2098
ISNE,"7/4/2016 11 p.m. EDT",14669,14270,12853,-1816
ISNE,"7/5/2016 12 a.m. EDT",13471,13080,11512,-1959
ISNE,"7/5/2016 1 a.m. EDT",12435,12300,10500,-1935
ISNE,"7/5/2016 2 a.m. EDT",12396,11660,10164,-2232
ISNE,"7/5/2016 3 a.m. EDT",12312,11280,10006,-2306
ISNE,"7/5/2016 4 a.m. EDT",12067,11110,9978,-2089
ISNE,"7/5/2016 5 a.m. EDT",12202,11380,10370,-1832
ISNE,"7/5/2016 6 a.m. EDT",12650,11880,10851,-1799
ISNE,"7/5/2016 7 a.m. EDT",13558,13100,11581,-1977
ISNE,"7/5/2016 8 a.m. EDT",14799,14410,12673,-2126
ISNE,"7/5/2016 9 a.m. EDT",15795,15670,13564,-2231
ISNE,"7/5/2016 10 a.m. EDT",16498,16600,14275,-2223
ISNE,"7/5/2016 11 a.m. EDT",17157,17580,14992,-2165
ISNE,"7/5/2016 12 p.m. EDT",17647,18490,15443,-2204
ISNE,"7/5/2016 1 p.m. EDT",18009,18720,15895,-2114
ISNE,"7/5/2016 2 p.m. EDT",18381,19440,16325,-2056
ISNE,"7/5/2016 3 p.m. EDT",18841,19730,16752,-2089
ISNE,"7/5/2016 4 p.m. EDT",19422,20110,17299,-2123
ISNE,"7/5/2016 5 p.m. EDT",20037,20710,17826,-2211
ISNE,"7/5/2016 6 p.m. EDT",20555,20800,18070,-2485
ISNE,"7/5/2016 7 p.m. EDT",20553,20420,17832,-2721
ISNE,"7/5/2016 8 p.m. EDT",20076,19690,17605,-2471
ISNE,"7/5/2016 9 p.m. EDT",19499,19290,17471,-2028
ISNE,"7/5/2016 10 p.m. EDT",18808,18590,16724,-2084
ISNE,"7/5/2016 11 p.m. EDT",17095,16990,14712,-2383
ISNE,"7/6/2016 12 a.m. EDT",15647,15480,13244,-2403
ISNE,"7/6/2016 1 a.m. EDT",14786,14080,12170,-2616
ISNE,"7/6/2016 2 a.m. EDT",14169,13210,11562,-2607
ISNE,"7/6/2016 3 a.m. EDT",13744,12650,11274,-2470
ISNE,"7/6/2016 4 a.m. EDT",13564,12370,11127,-2437
ISNE,"7/6/2016 5 a.m. EDT",13579,12320,11195,-2384
ISNE,"7/6/2016 6 a.m. EDT",14062,12820,11701,-2361
ISNE,"7/6/2016 7 a.m. EDT",15378,14390,12908,-2470
ISNE,"7/6/2016 8 a.m. EDT",16429,16300,14223,-2206
ISNE,"7/6/2016 9 a.m. EDT",17199,17640,14901,-2298
ISNE,"7/6/2016 10 a.m. EDT",18394,18950,16086,-2308
ISNE,"7/6/2016 11 a.m. EDT",19519,20100,17250,-2269
ISNE,"7/6/2016 12 p.m. EDT",20426,21000,18210,-2216
ISNE,"7/6/2016 1 p.m. EDT",21151,21610,18861,-2290
ISNE,"7/6/2016 2 p.m. EDT",21845,22240,19499,-2346
ISNE,"7/6/2016 3 p.m. EDT",22306,22550,19974,-2332
ISNE,"7/6/2016 4 p.m. EDT",22581,22790,20191,-2390
ISNE,"7/6/2016 5 p.m. EDT",22881,23000,20425,-2456
ISNE,"7/6/2016 6 p.m. EDT",23010,22910,20408,-2602
ISNE,"7/6/2016 7 p.m. EDT",22760,22400,20154,-2606
ISNE,"7/6/2016 8 p.m. EDT",22108,21710,19076,-3032
ISNE,"7/6/2016 9 p.m. EDT",21499,21240,18450,-3049
ISNE,"7/6/2016 10 p.m. EDT",20667,20340,17944,-2723
ISNE,"7/6/2016 11 p.m. EDT",18765,18390,16154,-2611
ISNE,"7/7/2016 12 a.m. EDT",17059,16480,14702,-2357
ISNE,"7/7/2016 1 a.m. EDT",16048,14940,13723,-2325
ISNE,"7/7/2016 2 a.m. EDT",15476,14040,13047,-2429
ISNE,"7/7/2016 3 a.m. EDT",15098,13470,12653,-2445
ISNE,"7/7/2016 4 a.m. EDT",14733,13170,12487,-2246
ISNE,"7/7/2016 5 a.m. EDT",14704,13430,12473,-2231
ISNE,"7/7/2016 6 a.m. EDT",15126,13990,12897,-2229
ISNE,"7/7/2016 7 a.m. EDT",15948,15310,13593,-2355
ISNE,"7/7/2016 8 a.m. EDT",16677,16940,14328,-2349
ISNE,"7/7/2016 9 a.m. EDT",17618,18190,15159,-2459
ISNE,"7/7/2016 10 a.m. EDT",18319,19190,15706,-2613
ISNE,"7/7/2016 11 a.m. EDT",18983,20200,16521,-2462
ISNE,"7/7/2016 12 p.m. EDT",19784,21070,17723,-2061
ISNE,"7/7/2016 1 p.m. EDT",20309,21710,18465,-1844
ISNE,"7/7/2016 2 p.m. EDT",20711,22340,18861,-1850
ISNE,"7/7/2016 3 p.m. EDT",20877,22740,19459,-1418
ISNE,"7/7/2016 4 p.m. EDT",20575,23060,18461,-2114
ISNE,"7/7/2016 5 p.m. EDT",20387,23250,17902,-2485
ISNE,"7/7/2016 6 p.m. EDT",20160,23060,17400,-2760
ISNE,"7/7/2016 7 p.m. EDT",19689,22550,16863,-2826
ISNE,"7/7/2016 8 p.m. EDT",19156,21940,16294,-2862
ISNE,"7/7/2016 9 p.m. EDT",18823,21310,15839,-2984
ISNE,"7/7/2016 10 p.m. EDT",18188,20370,15646,-2542
ISNE,"7/7/2016 11 p.m. EDT",16682,18570,14283,-2399
ISNE,"7/8/2016 12 a.m. EDT",15466,16710,13098,-2368
ISNE,"7/8/2016 1 a.m. EDT",14262,14620,12180,-2082
ISNE,"7/8/2016 2 a.m. EDT",13987,13780,11905,-2082
ISNE,"7/8/2016 3 a.m. EDT",13510,13260,11873,-1637
ISNE,"7/8/2016 4 a.m. EDT",13516,12970,11886,-1630
ISNE,"7/8/2016 5 a.m. EDT",13618,12450,11946,-1672
ISNE,"7/8/2016 6 a.m. EDT",13795,12970,12066,-1729
ISNE,"7/8/2016 7 a.m. EDT",14449,14310,12608,-1841
ISNE,"7/8/2016 8 a.m. EDT",15430,15870,13418,-2012
ISNE,"7/8/2016 9 a.m. EDT",16191,16850,14026,-2165
ISNE,"7/8/2016 10 a.m. EDT",16631,17600,14554,-2077
ISNE,"7/8/2016 11 a.m. EDT",16875,17120,14804,-2071
ISNE,"7/8/2016 12 p.m. EDT",17064,17470,15329,-1735
ISNE,"7/8/2016 1 p.m. EDT",17155,17710,15827,-1328
ISNE,"7/8/2016 2 p.m. EDT",17277,18070,16332,-945
ISNE,"7/8/2016 3 p.m. EDT",17313,18130,16131,-1182
ISNE,"7/8/2016 4 p.m. EDT",17279,18250,16375,-904
ISNE,"7/8/2016 5 p.m. EDT",17257,18300,16130,-1127
ISNE,"7/8/2016 6 p.m. EDT",17078,18190,15735,-1343
ISNE,"7/8/2016 7 p.m. EDT",16596,17670,15116,-1480
ISNE,"7/8/2016 8 p.m. EDT",16104,17020,14404,-1700
ISNE,"7/8/2016 9 p.m. EDT",15895,16650,14360,-1535
ISNE,"7/8/2016 10 p.m. EDT",15347,16140,14199,-1148
ISNE,"7/8/2016 11 p.m. EDT",14186,14950,13308,-878
ISNE,"7/9/2016 12 a.m. EDT",12882,13520,11841,-1041
ISNE,"7/9/2016 1 a.m. EDT",11858,12420,10131,-1727
ISNE,"7/9/2016 2 a.m. EDT",11213,11750,9620,-1593
ISNE,"7/9/2016 3 a.m. EDT",11032,11290,9348,-1684
ISNE,"7/9/2016 4 a.m. EDT",10799,11060,9242,-1557
ISNE,"7/9/2016 5 a.m. EDT",10941,10960,9221,-1720
ISNE,"7/9/2016 6 a.m. EDT",11155,10630,9318,-1837
ISNE,"7/9/2016 7 a.m. EDT",11331,11080,9288,-2043
ISNE,"7/9/2016 8 a.m. EDT",12030,11920,10184,-1846
ISNE,"7/9/2016 9 a.m. EDT",12723,12900,10787,-1936
ISNE,"7/9/2016 10 a.m. EDT",13464,13540,11215,-2249
ISNE,"7/9/2016 11 a.m. EDT",13875,13910,11662,-2213
ISNE,"7/9/2016 12 p.m. EDT",14071,14100,11799,-2272
ISNE,"7/9/2016 1 p.m. EDT",14074,14140,11717,-2357
ISNE,"7/9/2016 2 p.m. EDT",13921,14050,11534,-2387
ISNE,"7/9/2016 3 p.m. EDT",13786,14050,11352,-2434
ISNE,"7/9/2016 4 p.m. EDT",13825,14020,11472,-2353
ISNE,"7/9/2016 5 p.m. EDT",13875,14200,11675,-2200
ISNE,"7/9/2016 6 p.m. EDT",13895,14410,11790,-2105
ISNE,"7/9/2016 7 p.m. EDT",13814,14600,11748,-2066
ISNE,"7/9/2016 8 p.m. EDT",13738,14320,11997,-1741
ISNE,"7/9/2016 9 p.m. EDT",13793,14200,12243,-1550
ISNE,"7/9/2016 10 p.m. EDT",13400,13930,11753,-1647
ISNE,"7/9/2016 11 p.m. EDT",12553,13080,10881,-1672
ISNE,"7/10/2016 12 a.m. EDT",11588,12060,9930,-1658
ISNE,"7/10/2016 1 a.m. EDT",10793,11330,9169,-1624
ISNE,"7/10/2016 2 a.m. EDT",10295,10770,9157,-1138
ISNE,"7/10/2016 3 a.m. EDT",10249,10390,9078,-1171
ISNE,"7/10/2016 4 a.m. EDT",10103,10210,8592,-1511
ISNE,"7/10/2016 5 a.m. EDT",10062,10140,8714,-1348
ISNE,"7/10/2016 6 a.m. EDT",10206,9830,8751,-1455
ISNE,"7/10/2016 7 a.m. EDT",10560,10140,8620,-1940
ISNE,"7/10/2016 8 a.m. EDT",11032,10890,9142,-1890
ISNE,"7/10/2016 9 a.m. EDT",11632,11830,9666,-1966
ISNE,"7/10/2016 10 a.m. EDT",12491,12460,10286,-2205
ISNE,"7/10/2016 11 a.m. EDT",13115,13160,10993,-2122
ISNE,"7/10/2016 12 p.m. EDT",13510,13580,11426,-2084
ISNE,"7/10/2016 1 p.m. EDT",13751,13900,11557,-2194
ISNE,"7/10/2016 2 p.m. EDT",13863,13860,11796,-2067
ISNE,"7/10/2016 3 p.m. EDT",13926,14010,12085,-1841
ISNE,"7/10/2016 4 p.m. EDT",14067,14000,12225,-1842
ISNE,"7/10/2016 5 p.m. EDT",14348,14390,12480,-1868
ISNE,"7/10/2016 6 p.m. EDT",14662,14630,12959,-1703
ISNE,"7/10/2016 7 p.m. EDT",14704,14800,13001,-1703
ISNE,"7/10/2016 8 p.m. EDT",14549,14700,12896,-1653
ISNE,"7/10/2016 9 p.m. EDT",14498,14710,12802,-1696
ISNE,"7/10/2016 10 p.m. EDT",14085,14270,12605,-1480
ISNE,"7/10/2016 11 p.m. EDT",13010,13110,11655,-1355
ISNE,"7/11/2016 12 a.m. EDT",11833,11980,10349,-1484
ISNE,"7/11/2016 1 a.m. EDT",11149,11030,9587,-1562
ISNE,"7/11/2016 2 a.m. EDT",10697,10560,9455,-1242
ISNE,"7/11/2016 3 a.m. EDT",10412,10270,9708,-704
ISNE,"7/11/2016 4 a.m. EDT",10352,10210,9534,-818
ISNE,"7/11/2016 5 a.m. EDT",10591,10390,9804,-787
ISNE,"7/11/2016 6 a.m. EDT",11257,11090,10078,-1179
ISNE,"7/11/2016 7 a.m. EDT",12326,12560,10841,-1485
ISNE,"7/11/2016 8 a.m. EDT",13644,13860,11680,-1964
ISNE,"7/11/2016 9 a.m. EDT",14477,14630,12639,-1838
ISNE,"7/11/2016 10 a.m. EDT",15004,14980,12992,-2012
ISNE,"7/11/2016 11 a.m. EDT",15436,15520,13383,-2053
ISNE,"7/11/2016 12 p.m. EDT",15715,15860,13610,-2105
ISNE,"7/11/2016 1 p.m. EDT",15787,16030,13776,-2011
ISNE,"7/11/2016 2 p.m. EDT",15990,16300,13945,-2045
ISNE,"7/11/2016 3 p.m. EDT",16141,16490,14119,-2022
ISNE,"7/11/2016 4 p.m. EDT",16413,16620,14598,-1815
ISNE,"7/11/2016 5 p.m. EDT",16746,16900,15120,-1626
ISNE,"7/11/2016 6 p.m. EDT",16939,17150,15220,-1719
ISNE,"7/11/2016 7 p.m. EDT",16858,16840,14960,-1898
ISNE,"7/11/2016 8 p.m. EDT",16524,16540,14599,-1925
ISNE,"7/11/2016 9 p.m. EDT",16351,16340,14515,-1836
ISNE,"7/11/2016 10 p.m. EDT",15893,15750,13983,-1910
ISNE,"7/11/2016 11 p.m. EDT",14418,14250,12677,-1741
ISNE,"7/12/2016 12 a.m. EDT",12883,12830,10960,-1923
ISNE,"7/12/2016 1 a.m. EDT",12441,11780,10625,-1816
ISNE,"7/12/2016 2 a.m. EDT",12402,11070,10424,-1978
ISNE,"7/12/2016 3 a.m. EDT",12085,10690,10165,-1920
ISNE,"7/12/2016 4 a.m. EDT",11880,10550,10120,-1760
ISNE,"7/12/2016 5 a.m. EDT",11811,10690,10268,-1543
ISNE,"7/12/2016 6 a.m. EDT",11867,11330,10391,-1476
ISNE,"7/12/2016 7 a.m. EDT",12597,12810,10929,-1668
ISNE,"7/12/2016 8 a.m. EDT",14059,14270,12108,-1951
ISNE,"7/12/2016 9 a.m. EDT",15040,15220,13031,-2009
ISNE,"7/12/2016 10 a.m. EDT",15805,15870,13737,-2068
ISNE,"7/12/2016 11 a.m. EDT",16534,16660,14456,-2078
ISNE,"7/12/2016 12 p.m. EDT",17133,17290,15197,-1936
ISNE,"7/12/2016 1 p.m. EDT",17601,17620,15836,-1765
ISNE,"7/12/2016 2 p.m. EDT",18183,18250,16301,-1882
ISNE,"7/12/2016 3 p.m. EDT",18683,18560,16799,-1884
ISNE,"7/12/2016 4 p.m. EDT",19141,18890,17400,-1741
ISNE,"7/12/2016 5 p.m. EDT",19546,19220,17580,-1966
ISNE,"7/12/2016 6 p.m. EDT",19744,19390,17641,-2103
ISNE,"7/12/2016 7 p.m. EDT",19456,19020,17288,-2168
ISNE,"7/12/2016 8 p.m. EDT",18817,18500,16543,-2274
ISNE,"7/12/2016 9 p.m. EDT",18391,18080,16102,-2289
ISNE,"7/12/2016 10 p.m. EDT",17777,17360,15436,-2341
ISNE,"7/12/2016 11 p.m. EDT",16179,15690,13843,-2336
ISNE,"7/13/2016 12 a.m. EDT",14516,14030,12817,-1699
ISNE,"7/13/2016 1 a.m. EDT",13756,13040,11517,-2239
ISNE,"7/13/2016 2 a.m. EDT",13215,12320,10648,-2567
ISNE,"7/13/2016 3 a.m. EDT",13024,11890,10530,-2494
ISNE,"7/13/2016 4 a.m. EDT",13048,11670,10553,-2495
ISNE,"7/13/2016 5 a.m. EDT",13147,11840,10672,-2475
ISNE,"7/13/2016 6 a.m. EDT",13492,12450,10800,-2692
ISNE,"7/13/2016 7 a.m. EDT",14018,13910,11292,-2726
ISNE,"7/13/2016 8 a.m. EDT",15545,15520,12934,-2611
ISNE,"7/13/2016 9 a.m. EDT",16749,16690,13862,-2887
ISNE,"7/13/2016 10 a.m. EDT",17733,17580,14963,-2770
ISNE,"7/13/2016 11 a.m. EDT",18757,18620,16082,-2675
ISNE,"7/13/2016 12 p.m. EDT",19669,19380,16798,-2871
ISNE,"7/13/2016 1 p.m. EDT",20403,20000,17269,-3134
ISNE,"7/13/2016 2 p.m. EDT",21126,20690,17677,-3449
ISNE,"7/13/2016 3 p.m. EDT",21503,21150,17856,-3647
ISNE,"7/13/2016 4 p.m. EDT",21828,21480,18368,-3460
ISNE,"7/13/2016 5 p.m. EDT",22086,21800,19060,-3026
ISNE,"7/13/2016 6 p.m. EDT",22147,21620,18892,-3255
ISNE,"7/13/2016 7 p.m. EDT",21671,20980,18157,-3514
ISNE,"7/13/2016 8 p.m. EDT",20869,20300,17108,-3761
ISNE,"7/13/2016 9 p.m. EDT",20245,19800,16679,-3566
ISNE,"7/13/2016 10 p.m. EDT",19419,18880,15956,-3463
ISNE,"7/13/2016 11 p.m. EDT",17567,17110,14508,-3059
ISNE,"7/14/2016 12 a.m. EDT",15937,15320,12829,-3108
ISNE,"7/14/2016 1 a.m. EDT",14736,14170,11971,-2765
ISNE,"7/14/2016 2 a.m. EDT",14368,13430,11823,-2545
ISNE,"7/14/2016 3 a.m. EDT",14090,12960,11578,-2512
ISNE,"7/14/2016 4 a.m. EDT",13929,12740,11460,-2469
ISNE,"7/14/2016 5 a.m. EDT",14136,12920,11632,-2504
ISNE,"7/14/2016 6 a.m. EDT",14349,13600,12175,-2174
ISNE,"7/14/2016 7 a.m. EDT",15358,14990,13030,-2328
ISNE,"7/14/2016 8 a.m. EDT",16822,16530,14261,-2561
ISNE,"7/14/2016 9 a.m. EDT",17802,17670,15027,-2775
ISNE,"7/14/2016 10 a.m. EDT",18635,18610,15499,-3136
ISNE,"7/14/2016 11 a.m. EDT",19465,19580,16310,-3155
ISNE,"7/14/2016 12 p.m. EDT",20048,20430,17002,-3046
ISNE,"7/14/2016 1 p.m. EDT",20472,21080,17414,-3058
ISNE,"7/14/2016 2 p.m. EDT",20822,21780,17858,-2964
ISNE,"7/14/2016 3 p.m. EDT",21056,22230,18283,-2773
ISNE,"7/14/2016 4 p.m. EDT",21184,22510,18696,-2488
ISNE,"7/14/2016 5 p.m. EDT",21173,22750,18667,-2506
ISNE,"7/14/2016 6 p.m. EDT",21184,22720,18416,-2768
ISNE,"7/14/2016 7 p.m. EDT",20889,22300,17918,-2971
ISNE,"7/14/2016 8 p.m. EDT",20399,21820,17459,-2940
ISNE,"7/14/2016 9 p.m. EDT",20130,21340,17348,-2782
ISNE,"7/14/2016 10 p.m. EDT",19467,20440,16873,-2594
ISNE,"7/14/2016 11 p.m. EDT",17856,18630,15381,-2475
ISNE,"7/15/2016 12 a.m. EDT",16506,16880,13745,-2761
ISNE,"7/15/2016 1 a.m. EDT",15563,15240,12570,-2993
ISNE,"7/15/2016 2 a.m. EDT",15049,14360,12207,-2842
ISNE,"7/15/2016 3 a.m. EDT",14573,13790,12092,-2481
ISNE,"7/15/2016 4 a.m. EDT",14301,13510,12180,-2121
ISNE,"7/15/2016 5 a.m. EDT",14275,13560,12343,-1932
ISNE,"7/15/2016 6 a.m. EDT",14285,13990,12241,-2044
ISNE,"7/15/2016 7 a.m. EDT",15380,15320,12914,-2466
ISNE,"7/15/2016 8 a.m. EDT",17195,17070,14651,-2544
ISNE,"7/15/2016 9 a.m. EDT",18749,18360,16145,-2604
ISNE,"7/15/2016 10 a.m. EDT",19958,19400,17120,-2838
ISNE,"7/15/2016 11 a.m. EDT",21075,20550,17997,-3078
ISNE,"7/15/2016 12 p.m. EDT",21802,21430,18555,-3247
ISNE,"7/15/2016 1 p.m. EDT",22308,22080,18773,-3535
ISNE,"7/15/2016 2 p.m. EDT",22723,22660,18882,-3841
ISNE,"7/15/2016 3 p.m. EDT",22884,23120,19041,-3843
ISNE,"7/15/2016 4 p.m. EDT",22900,23290,19314,-3586
ISNE,"7/15/2016 5 p.m. EDT",22910,23400,19358,-3552
ISNE,"7/15/2016 6 p.m. EDT",22878,23130,19060,-3818
ISNE,"7/15/2016 7 p.m. EDT",22552,22470,18961,-3591
ISNE,"7/15/2016 8 p.m. EDT",21890,21750,18273,-3617
ISNE,"7/15/2016 9 p.m. EDT",21237,21110,17573,-3664
ISNE,"7/15/2016 10 p.m. EDT",20441,20290,16899,-3542
ISNE,"7/15/2016 11 p.m. EDT",18813,18620,15763,-3050
ISNE,"7/16/2016 12 a.m. EDT",17194,16870,14307,-2887
ISNE,"7/16/2016 1 a.m. EDT",16029,15170,13315,-2714
ISNE,"7/16/2016 2 a.m. EDT",15272,14250,12668,-2604
ISNE,"7/16/2016 3 a.m. EDT",14865,13560,12272,-2593
ISNE,"7/16/2016 4 a.m. EDT",14355,13090,11771,-2584
ISNE,"7/16/2016 5 a.m. EDT",14323,12980,11501,-2822
ISNE,"7/16/2016 6 a.m. EDT",14229,12970,11473,-2756
ISNE,"7/16/2016 7 a.m. EDT",14706,13500,11849,-2857
ISNE,"7/16/2016 8 a.m. EDT",14823,14640,12668,-2155
ISNE,"7/16/2016 9 a.m. EDT",16050,16020,14217,-1833
ISNE,"7/16/2016 10 a.m. EDT",17266,17090,15438,-1828
ISNE,"7/16/2016 11 a.m. EDT",18259,18110,16020,-2239
ISNE,"7/16/2016 12 p.m. EDT",18988,18800,16834,-2154
ISNE,"7/16/2016 1 p.m. EDT",19495,19420,17406,-2089
ISNE,"7/16/2016 2 p.m. EDT",19919,19760,17717,-2202
ISNE,"7/16/2016 3 p.m. EDT",20236,20050,18010,-2226
ISNE,"7/16/2016 4 p.m. EDT",20591,20380,18311,-2280
ISNE,"7/16/2016 5 p.m. EDT",20749,20440,18344,-2405
ISNE,"7/16/2016 6 p.m. EDT",20751,20500,18069,-2682
ISNE,"7/16/2016 7 p.m. EDT",20308,20340,17469,-2839
ISNE,"7/16/2016 8 p.m. EDT",19696,19570,16848,-2848
ISNE,"7/16/2016 9 p.m. EDT",19346,19270,16348,-2998
ISNE,"7/16/2016 10 p.m. EDT",18807,18550,15849,-2958
ISNE,"7/16/2016 11 p.m. EDT",17476,17310,14723,-2753
ISNE,"7/17/2016 12 a.m. EDT",16105,15800,13082,-3023
ISNE,"7/17/2016 1 a.m. EDT",15160,14720,12169,-2991
ISNE,"7/17/2016 2 a.m. EDT",14825,13960,11488,-3337
ISNE,"7/17/2016 3 a.m. EDT",14740,13380,11334,-3406
ISNE,"7/17/2016 4 a.m. EDT",14650,12950,11289,-3361
ISNE,"7/17/2016 5 a.m. EDT",14508,12910,11215,-3293
ISNE,"7/17/2016 6 a.m. EDT",14447,12770,11427,-3020
ISNE,"7/17/2016 7 a.m. EDT",14400,12990,11407,-2993
ISNE,"7/17/2016 8 a.m. EDT",15007,13830,12094,-2913
ISNE,"7/17/2016 9 a.m. EDT",15015,15040,12375,-2640
ISNE,"7/17/2016 10 a.m. EDT",15924,16090,13350,-2574
ISNE,"7/17/2016 11 a.m. EDT",16991,16960,14609,-2382
ISNE,"7/17/2016 12 p.m. EDT",17930,17670,15459,-2471
ISNE,"7/17/2016 1 p.m. EDT",18667,18410,15852,-2815
ISNE,"7/17/2016 2 p.m. EDT",19107,18810,16321,-2786
ISNE,"7/17/2016 3 p.m. EDT",19477,19090,16755,-2722
ISNE,"7/17/2016 4 p.m. EDT",19857,19380,17207,-2650
ISNE,"7/17/2016 5 p.m. EDT",20252,19740,17493,-2759
ISNE,"7/17/2016 6 p.m. EDT",20510,19880,17769,-2741
ISNE,"7/17/2016 7 p.m. EDT",20409,19750,17943,-2466
ISNE,"7/17/2016 8 p.m. EDT",19919,19280,17584,-2335
ISNE,"7/17/2016 9 p.m. EDT",19613,19110,17097,-2516
ISNE,"7/17/2016 10 p.m. EDT",19015,18430,16263,-2752
ISNE,"7/17/2016 11 p.m. EDT",17364,17080,14625,-2739
ISNE,"7/18/2016 12 a.m. EDT",15966,15540,13195,-2771
ISNE,"7/18/2016 1 a.m. EDT",14812,14410,12134,-2678
ISNE,"7/18/2016 2 a.m. EDT",14692,13560,11832,-2860
ISNE,"7/18/2016 3 a.m. EDT",14423,13070,11420,-3003
ISNE,"7/18/2016 4 a.m. EDT",14474,12880,11546,-2928
ISNE,"7/18/2016 5 a.m. EDT",14567,12980,11735,-2832
ISNE,"7/18/2016 6 a.m. EDT",14714,13730,12178,-2536
ISNE,"7/18/2016 7 a.m. EDT",15871,15080,13228,-2643
ISNE,"7/18/2016 8 a.m. EDT",16936,16760,14337,-2599
ISNE,"7/18/2016 9 a.m. EDT",18110,18010,15389,-2721
ISNE,"7/18/2016 10 a.m. EDT",19360,19030,16651,-2709
ISNE,"7/18/2016 11 a.m. EDT",20622,20080,18014,-2608
ISNE,"7/18/2016 12 p.m. EDT",21671,20920,19035,-2636
ISNE,"7/18/2016 1 p.m. EDT",22450,21550,19311,-3139
ISNE,"7/18/2016 2 p.m. EDT",23208,22050,20060,-3148
ISNE,"7/18/2016 3 p.m. EDT",23617,22460,20346,-3271
ISNE,"7/18/2016 4 p.m. EDT",23083,22720,20205,-2878
ISNE,"7/18/2016 5 p.m. EDT",22391,22740,19768,-2623
ISNE,"7/18/2016 6 p.m. EDT",21851,22900,19276,-2575
ISNE,"7/18/2016 7 p.m. EDT",21484,22260,18461,-3023
ISNE,"7/18/2016 8 p.m. EDT",21066,21780,18119,-2947
ISNE,"7/18/2016 9 p.m. EDT",20707,21250,17778,-2929
ISNE,"7/18/2016 10 p.m. EDT",19881,20240,16779,-3102
ISNE,"7/18/2016 11 p.m. EDT",18147,18440,15154,-2993
ISNE,"7/19/2016 12 a.m. EDT",16660,16700,13882,-2778
ISNE,"7/19/2016 1 a.m. EDT",15607,15230,13166,-2441
ISNE,"7/19/2016 2 a.m. EDT",15181,14280,12646,-2535
ISNE,"7/19/2016 3 a.m. EDT",14791,13630,12027,-2764
ISNE,"7/19/2016 4 a.m. EDT",14802,13270,11984,-2818
ISNE,"7/19/2016 5 a.m. EDT",14943,13200,12058,-2885
ISNE,"7/19/2016 6 a.m. EDT",14909,13750,12144,-2765
ISNE,"7/19/2016 7 a.m. EDT",15563,14950,12896,-2667
ISNE,"7/19/2016 8 a.m. EDT",16520,16100,14211,-2309
ISNE,"7/19/2016 9 a.m. EDT",17283,16870,14591,-2692
ISNE,"7/19/2016 10 a.m. EDT",17824,17400,15109,-2715
ISNE,"7/19/2016 11 a.m. EDT",18374,17940,15661,-2713
ISNE,"7/19/2016 12 p.m. EDT",18835,18370,15998,-2837
ISNE,"7/19/2016 1 p.m. EDT",19021,18580,16209,-2812
ISNE,"7/19/2016 2 p.m. EDT",19247,18960,16538,-2709
ISNE,"7/19/2016 3 p.m. EDT",19340,19220,16516,-2824
ISNE,"7/19/2016 4 p.m. EDT",19393,19310,16547,-2846
ISNE,"7/19/2016 5 p.m. EDT",19399,19450,16716,-2683
ISNE,"7/19/2016 6 p.m. EDT",19286,19370,16287,-2999
ISNE,"7/19/2016 7 p.m. EDT",18777,18860,16031,-2746
ISNE,"7/19/2016 8 p.m. EDT",18032,18130,15214,-2818
ISNE,"7/19/2016 9 p.m. EDT",17524,17810,14934,-2590
ISNE,"7/19/2016 10 p.m. EDT",16800,16960,14588,-2212
ISNE,"7/19/2016 11 p.m. EDT",15194,15370,12966,-2228
ISNE,"7/20/2016 12 a.m. EDT",13599,13780,11297,-2302
ISNE,"7/20/2016 1 a.m. EDT",12717,12760,10207,-2510
ISNE,"7/20/2016 2 a.m. EDT",12360,12030,9716,-2644
ISNE,"7/20/2016 3 a.m. EDT",12125,11520,9723,-2402
ISNE,"7/20/2016 4 a.m. EDT",11801,11280,9901,-1900
ISNE,"7/20/2016 5 a.m. EDT",11882,11110,10011,-1871
ISNE,"7/20/2016 6 a.m. EDT",12196,11730,10333,-1863
ISNE,"7/20/2016 7 a.m. EDT",13174,13070,11027,-2147
ISNE,"7/20/2016 8 a.m. EDT",14256,14450,12056,-2200
ISNE,"7/20/2016 9 a.m. EDT",15105,15240,12857,-2248
ISNE,"7/20/2016 10 a.m. EDT",15689,15790,13608,-2081
ISNE,"7/20/2016 11 a.m. EDT",16157,16370,13987,-2170
ISNE,"7/20/2016 12 p.m. EDT",16603,16790,14396,-2207
ISNE,"7/20/2016 1 p.m. EDT",16941,17120,14508,-2433
ISNE,"7/20/2016 2 p.m. EDT",17443,17550,14906,-2537
ISNE,"7/20/2016 3 p.m. EDT",17836,17890,15380,-2456
ISNE,"7/20/2016 4 p.m. EDT",18191,18200,15889,-2302
ISNE,"7/20/2016 5 p.m. EDT",18618,18500,16375,-2243
ISNE,"7/20/2016 6 p.m. EDT",18808,18430,16285,-2523
ISNE,"7/20/2016 7 p.m. EDT",18526,18040,15795,-2731
ISNE,"7/20/2016 8 p.m. EDT",17970,17540,15355,-2615
ISNE,"7/20/2016 9 p.m. EDT",17710,17140,15178,-2532
ISNE,"7/20/2016 10 p.m. EDT",17058,16470,14826,-2232
ISNE,"7/20/2016 11 p.m. EDT",15465,14940,13151,-2314
ISNE,"7/21/2016 12 a.m. EDT",13855,13420,11410,-2445
ISNE,"7/21/2016 1 a.m. EDT",12913,12360,10594,-2319
ISNE,"7/21/2016 2 a.m. EDT",12194,11650,10270,-1924
ISNE,"7/21/2016 3 a.m. EDT",11713,11170,10336,-1377
ISNE,"7/21/2016 4 a.m. EDT",11479,10930,10268,-1211
ISNE,"7/21/2016 5 a.m. EDT",11836,11020,10245,-1591
ISNE,"7/21/2016 6 a.m. EDT",12644,11900,10408,-2236
ISNE,"7/21/2016 7 a.m. EDT",13687,13290,11333,-2354
ISNE,"7/21/2016 8 a.m. EDT",15204,14730,12742,-2462
ISNE,"7/21/2016 9 a.m. EDT",15804,15760,13486,-2318
ISNE,"7/21/2016 10 a.m. EDT",16586,16610,14107,-2479
ISNE,"7/21/2016 11 a.m. EDT",17417,17460,15113,-2304
ISNE,"7/21/2016 12 p.m. EDT",18111,18110,16052,-2059
ISNE,"7/21/2016 1 p.m. EDT",18695,18680,16714,-1981
ISNE,"7/21/2016 2 p.m. EDT",19418,19340,17471,-1947
ISNE,"7/21/2016 3 p.m. EDT",20041,19730,18009,-2032
ISNE,"7/21/2016 4 p.m. EDT",20629,20190,18382,-2247
ISNE,"7/21/2016 5 p.m. EDT",21164,20480,18712,-2452
ISNE,"7/21/2016 6 p.m. EDT",21396,20520,18980,-2416
ISNE,"7/21/2016 7 p.m. EDT",21154,20030,18493,-2661
ISNE,"7/21/2016 8 p.m. EDT",20572,19460,17724,-2848
ISNE,"7/21/2016 9 p.m. EDT",20171,19200,17208,-2963
ISNE,"7/21/2016 10 p.m. EDT",19392,18430,16504,-2888
ISNE,"7/21/2016 11 p.m. EDT",17694,16720,15089,-2605
ISNE,"7/22/2016 12 a.m. EDT",16029,15100,13067,-2962
ISNE,"7/22/2016 1 a.m. EDT",15368,13800,12384,-2984
ISNE,"7/22/2016 2 a.m. EDT",15120,12980,12452,-2668
ISNE,"7/22/2016 3 a.m. EDT",14906,12500,12261,-2645
ISNE,"7/22/2016 4 a.m. EDT",14586,12250,11890,-2696
ISNE,"7/22/2016 5 a.m. EDT",14439,12360,11676,-2763
ISNE,"7/22/2016 6 a.m. EDT",14728,13790,12057,-2671
ISNE,"7/22/2016 7 a.m. EDT",15512,15240,13094,-2418
ISNE,"7/22/2016 8 a.m. EDT",16727,16820,14544,-2183
ISNE,"7/22/2016 9 a.m. EDT",17877,18250,15604,-2273
ISNE,"7/22/2016 10 a.m. EDT",18955,19440,16656,-2299
ISNE,"7/22/2016 11 a.m. EDT",20179,20350,17627,-2552
ISNE,"7/22/2016 12 p.m. EDT",21262,21340,18588,-2674
ISNE,"7/22/2016 1 p.m. EDT",22213,22260,19473,-2740
ISNE,"7/22/2016 2 p.m. EDT",23086,23010,20389,-2697
ISNE,"7/22/2016 3 p.m. EDT",23646,23600,20857,-2789
ISNE,"7/22/2016 4 p.m. EDT",24015,23910,20916,-3099
ISNE,"7/22/2016 5 p.m. EDT",24254,24000,20825,-3429
ISNE,"7/22/2016 6 p.m. EDT",24305,23870,21139,-3166
ISNE,"7/22/2016 7 p.m. EDT",23880,23220,20963,-2917
ISNE,"7/22/2016 8 p.m. EDT",23141,22570,20196,-2945
ISNE,"7/22/2016 9 p.m. EDT",22423,21920,19220,-3203
ISNE,"7/22/2016 10 p.m. EDT",21387,21130,18350,-3037
ISNE,"7/22/2016 11 p.m. EDT",19676,19410,16743,-2933
ISNE,"7/23/2016 12 a.m. EDT",18088,17590,14905,-3183
ISNE,"7/23/2016 1 a.m. EDT",16980,16410,13936,-3044
ISNE,"7/23/2016 2 a.m. EDT",16338,15340,13357,-2981
ISNE,"7/23/2016 3 a.m. EDT",15853,14750,12785,-3068
ISNE,"7/23/2016 4 a.m. EDT",15567,14270,12903,-2664
ISNE,"7/23/2016 5 a.m. EDT",15275,14080,12651,-2624
ISNE,"7/23/2016 6 a.m. EDT",15444,14070,12781,-2663
ISNE,"7/23/2016 7 a.m. EDT",15754,14710,13200,-2554
ISNE,"7/23/2016 8 a.m. EDT",16298,15880,13925,-2373
ISNE,"7/23/2016 9 a.m. EDT",17261,17360,14845,-2416
ISNE,"7/23/2016 10 a.m. EDT",18473,18680,15858,-2615
ISNE,"7/23/2016 11 a.m. EDT",19520,19760,16567,-2953
ISNE,"7/23/2016 12 p.m. EDT",20313,20630,17137,-3176
ISNE,"7/23/2016 1 p.m. EDT",20895,21150,17829,-3066
ISNE,"7/23/2016 2 p.m. EDT",21333,21570,18450,-2883
ISNE,"7/23/2016 3 p.m. EDT",21553,21830,18767,-2786
ISNE,"7/23/2016 4 p.m. EDT",21733,21970,18882,-2851
ISNE,"7/23/2016 5 p.m. EDT",21926,22000,19015,-2911
ISNE,"7/23/2016 6 p.m. EDT",21929,21980,19062,-2867
ISNE,"7/23/2016 7 p.m. EDT",21262,21510,18362,-2900
ISNE,"7/23/2016 8 p.m. EDT",20158,20740,17053,-3105
ISNE,"7/23/2016 9 p.m. EDT",19281,20200,16368,-2913
ISNE,"7/23/2016 10 p.m. EDT",18462,19540,15913,-2549
ISNE,"7/23/2016 11 p.m. EDT",16998,17970,14673,-2325
ISNE,"7/24/2016 12 a.m. EDT",15662,16340,13957,-1705
ISNE,"7/24/2016 1 a.m. EDT",14679,14770,12429,-2250
ISNE,"7/24/2016 2 a.m. EDT",14220,13950,12057,-2163
ISNE,"7/24/2016 3 a.m. EDT",14095,13290,11914,-2181
ISNE,"7/24/2016 4 a.m. EDT",13836,12840,11527,-2309
ISNE,"7/24/2016 5 a.m. EDT",13592,12630,11318,-2274
ISNE,"7/24/2016 6 a.m. EDT",13472,11970,11516,-1956
ISNE,"7/24/2016 7 a.m. EDT",13727,12200,11608,-2119
ISNE,"7/24/2016 8 a.m. EDT",13787,13080,11710,-2077
ISNE,"7/24/2016 9 a.m. EDT",14276,14370,12337,-1939
ISNE,"7/24/2016 10 a.m. EDT",15419,15470,13658,-1761
ISNE,"7/24/2016 11 a.m. EDT",16383,16540,14478,-1905
ISNE,"7/24/2016 12 p.m. EDT",17248,17310,15094,-2154
ISNE,"7/24/2016 1 p.m. EDT",17970,18060,15890,-2080
ISNE,"7/24/2016 2 p.m. EDT",18408,18500,16166,-2242
ISNE,"7/24/2016 3 p.m. EDT",18933,18980,16557,-2376
ISNE,"7/24/2016 4 p.m. EDT",19513,19550,17141,-2372
ISNE,"7/24/2016 5 p.m. EDT",20085,20030,17411,-2674
ISNE,"7/24/2016 6 p.m. EDT",20542,20300,17659,-2883
ISNE,"7/24/2016 7 p.m. EDT",20478,19890,17377,-3101
ISNE,"7/24/2016 8 p.m. EDT",19935,19400,16992,-2943
ISNE,"7/24/2016 9 p.m. EDT",19528,18990,16914,-2614
ISNE,"7/24/2016 10 p.m. EDT",18778,18280,16445,-2333
ISNE,"7/24/2016 11 p.m. EDT",17128,16790,14893,-2235
ISNE,"7/25/2016 12 a.m. EDT",15850,15220,13561,-2289
ISNE,"7/25/2016 1 a.m. EDT",14761,13980,12239,-2522
ISNE,"7/25/2016 2 a.m. EDT",14194,13280,11650,-2544
ISNE,"7/25/2016 3 a.m. EDT",13867,12810,11656,-2211
ISNE,"7/25/2016 4 a.m. EDT",13340,12590,11710,-1630
ISNE,"7/25/2016 5 a.m. EDT",13402,12910,11678,-1724
ISNE,"7/25/2016 6 a.m. EDT",13793,13390,12136,-1657
ISNE,"7/25/2016 7 a.m. EDT",14779,14900,12408,-2371
ISNE,"7/25/2016 8 a.m. EDT",16180,16750,13603,-2577
ISNE,"7/25/2016 9 a.m. EDT",17448,18080,14817,-2631
ISNE,"7/25/2016 10 a.m. EDT",18640,19530,15890,-2750
ISNE,"7/25/2016 11 a.m. EDT",19975,20790,16895,-3080
ISNE,"7/25/2016 12 p.m. EDT",21175,21960,17860,-3315
ISNE,"7/25/2016 1 p.m. EDT",22124,22750,18890,-3234
ISNE,"7/25/2016 2 p.m. EDT",23074,23600,19817,-3257
ISNE,"7/25/2016 3 p.m. EDT",23591,24080,20640,-2951
ISNE,"7/25/2016 4 p.m. EDT",23641,24500,20677,-2964
ISNE,"7/25/2016 5 p.m. EDT",23411,24340,20573,-2838
ISNE,"7/25/2016 6 p.m. EDT",23220,24070,20592,-2628
ISNE,"7/25/2016 7 p.m. EDT",22726,23640,19976,-2750
ISNE,"7/25/2016 8 p.m. EDT",22101,22920,18882,-3219
ISNE,"7/25/2016 9 p.m. EDT",21609,22280,18475,-3134
ISNE,"7/25/2016 10 p.m. EDT",20597,21090,17095,-3502
ISNE,"7/25/2016 11 p.m. EDT",19012,19110,15969,-3043
ISNE,"7/26/2016 12 a.m. EDT",17355,17260,14358,-2997
ISNE,"7/26/2016 1 a.m. EDT",16555,15800,13689,-2866
ISNE,"7/26/2016 2 a.m. EDT",16142,14840,13115,-3027
ISNE,"7/26/2016 3 a.m. EDT",15820,14330,12792,-3028
ISNE,"7/26/2016 4 a.m. EDT",15465,14000,12731,-2734
ISNE,"7/26/2016 5 a.m. EDT",15439,14080,12730,-2709
ISNE,"7/26/2016 6 a.m. EDT",15724,14560,13037,-2687
ISNE,"7/26/2016 7 a.m. EDT",16559,15910,13657,-2902
ISNE,"7/26/2016 8 a.m. EDT",17587,17530,14780,-2807
ISNE,"7/26/2016 9 a.m. EDT",18782,18680,15926,-2856
ISNE,"7/26/2016 10 a.m. EDT",19754,19690,16562,-3192
ISNE,"7/26/2016 11 a.m. EDT",20685,20710,17689,-2996
ISNE,"7/26/2016 12 p.m. EDT",21468,21610,18365,-3103
ISNE,"7/26/2016 1 p.m. EDT",22014,22220,18767,-3247
ISNE,"7/26/2016 2 p.m. EDT",22690,22910,19543,-3147
ISNE,"7/26/2016 3 p.m. EDT",23159,23320,20162,-2997
ISNE,"7/26/2016 4 p.m. EDT",23455,23520,20548,-2907
ISNE,"7/26/2016 5 p.m. EDT",23742,23800,20910,-2832
ISNE,"7/26/2016 6 p.m. EDT",23839,23610,20863,-2976
ISNE,"7/26/2016 7 p.m. EDT",23445,23000,20424,-3021
ISNE,"7/26/2016 8 p.m. EDT",22679,22280,19618,-3061
ISNE,"7/26/2016 9 p.m. EDT",22038,21840,18789,-3249
ISNE,"7/26/2016 10 p.m. EDT",20987,20750,18017,-2970
ISNE,"7/26/2016 11 p.m. EDT",19015,18750,16237,-2778
ISNE,"7/27/2016 12 a.m. EDT",17319,16810,14510,-2809
ISNE,"7/27/2016 1 a.m. EDT",16013,15300,13298,-2715
ISNE,"7/27/2016 2 a.m. EDT",15459,14300,12738,-2721
ISNE,"7/27/2016 3 a.m. EDT",15315,13730,12404,-2911
ISNE,"7/27/2016 4 a.m. EDT",14937,13410,12065,-2872
ISNE,"7/27/2016 5 a.m. EDT",14892,13450,12044,-2848
ISNE,"7/27/2016 6 a.m. EDT",15113,13840,12532,-2581
ISNE,"7/27/2016 7 a.m. EDT",15665,15320,13213,-2452
ISNE,"7/27/2016 8 a.m. EDT",16801,16940,14387,-2414
ISNE,"7/27/2016 9 a.m. EDT",17998,18170,15332,-2666
ISNE,"7/27/2016 10 a.m. EDT",19023,19220,16634,-2389
ISNE,"7/27/2016 11 a.m. EDT",20071,20310,17644,-2427
ISNE,"7/27/2016 12 p.m. EDT",20981,21270,18366,-2615
ISNE,"7/27/2016 1 p.m. EDT",21730,21960,18614,-3116
ISNE,"7/27/2016 2 p.m. EDT",22384,22710,18893,-3491
ISNE,"7/27/2016 3 p.m. EDT",22817,23290,19453,-3364
ISNE,"7/27/2016 4 p.m. EDT",23149,23350,19980,-3169
ISNE,"7/27/2016 5 p.m. EDT",23487,23570,20581,-2906
ISNE,"7/27/2016 6 p.m. EDT",23620,23460,20766,-2854
ISNE,"7/27/2016 7 p.m. EDT",23212,23000,20250,-2962
ISNE,"7/27/2016 8 p.m. EDT",22378,22280,19106,-3272
ISNE,"7/27/2016 9 p.m. EDT",21781,21840,18376,-3405
ISNE,"7/27/2016 10 p.m. EDT",20761,20770,17699,-3062
ISNE,"7/27/2016 11 p.m. EDT",18875,18740,16053,-2822
ISNE,"7/28/2016 12 a.m. EDT",17085,16790,14214,-2871
ISNE,"7/28/2016 1 a.m. EDT",15816,15430,13464,-2352
ISNE,"7/28/2016 2 a.m. EDT",15334,14500,12850,-2484
ISNE,"7/28/2016 3 a.m. EDT",15268,13850,12794,-2474
ISNE,"7/28/2016 4 a.m. EDT",15158,13550,12768,-2390
ISNE,"7/28/2016 5 a.m. EDT",14931,13560,12742,-2189
ISNE,"7/28/2016 6 a.m. EDT",15200,14010,13189,-2011
ISNE,"7/28/2016 7 a.m. EDT",15827,15430,13650,-2177
ISNE,"7/28/2016 8 a.m. EDT",17083,17190,14908,-2175
ISNE,"7/28/2016 9 a.m. EDT",18372,18530,16097,-2275
ISNE,"7/28/2016 10 a.m. EDT",19621,19730,17297,-2324
ISNE,"7/28/2016 11 a.m. EDT",20885,20790,18258,-2627
ISNE,"7/28/2016 12 p.m. EDT",21882,21690,19042,-2840
ISNE,"7/28/2016 1 p.m. EDT",22590,22420,19642,-2948
ISNE,"7/28/2016 2 p.m. EDT",23268,23150,20386,-2882
ISNE,"7/28/2016 3 p.m. EDT",23573,23600,20817,-2756
ISNE,"7/28/2016 4 p.m. EDT",23689,23790,21001,-2688
ISNE,"7/28/2016 5 p.m. EDT",23738,23940,21019,-2719
ISNE,"7/28/2016 6 p.m. EDT",23698,23870,20547,-3151
ISNE,"7/28/2016 7 p.m. EDT",23165,23240,19827,-3338
ISNE,"7/28/2016 8 p.m. EDT",22531,22640,19020,-3511
ISNE,"7/28/2016 9 p.m. EDT",22273,22150,18704,-3569
ISNE,"7/28/2016 10 p.m. EDT",21295,21180,18019,-3276
ISNE,"7/28/2016 11 p.m. EDT",19538,19240,16572,-2966
ISNE,"7/29/2016 12 a.m. EDT",17839,17370,15666,-2173
ISNE,"7/29/2016 1 a.m. EDT",16782,15970,13984,-2798
ISNE,"7/29/2016 2 a.m. EDT",16352,15110,13473,-2879
ISNE,"7/29/2016 3 a.m. EDT",16036,14570,13069,-2967
ISNE,"7/29/2016 4 a.m. EDT",15699,14270,12933,-2766
ISNE,"7/29/2016 5 a.m. EDT",15465,14320,12639,-2826
ISNE,"7/29/2016 6 a.m. EDT",15811,15200,13110,-2701
ISNE,"7/29/2016 7 a.m. EDT",16641,16430,13737,-2904
ISNE,"7/29/2016 8 a.m. EDT",17590,17750,14641,-2949
ISNE,"7/29/2016 9 a.m. EDT",18275,18570,15311,-2964
ISNE,"7/29/2016 10 a.m. EDT",18762,19200,15608,-3154
ISNE,"7/29/2016 11 a.m. EDT",19082,19870,15941,-3141
ISNE,"7/29/2016 12 p.m. EDT",19320,20340,16328,-2992
ISNE,"7/29/2016 1 p.m. EDT",19478,20660,16558,-2920
ISNE,"7/29/2016 2 p.m. EDT",19863,21010,17046,-2817
ISNE,"7/29/2016 3 p.m. EDT",20457,21230,17617,-2840
ISNE,"7/29/2016 4 p.m. EDT",20966,21330,18095,-2871
ISNE,"7/29/2016 5 p.m. EDT",21354,21500,18465,-2889
ISNE,"7/29/2016 6 p.m. EDT",21368,21220,18554,-2814
ISNE,"7/29/2016 7 p.m. EDT",20833,20510,17463,-3370
ISNE,"7/29/2016 8 p.m. EDT",20054,19780,16759,-3295
ISNE,"7/29/2016 9 p.m. EDT",19619,19400,16479,-3140
ISNE,"7/29/2016 10 p.m. EDT",18855,18650,15536,-3319
ISNE,"7/29/2016 11 p.m. EDT",17407,17210,14305,-3102
ISNE,"7/30/2016 12 a.m. EDT",15804,15650,12669,-3135
ISNE,"7/30/2016 1 a.m. EDT",14575,14450,11393,-3182
ISNE,"7/30/2016 2 a.m. EDT",14170,13550,10829,-3341
ISNE,"7/30/2016 3 a.m. EDT",13654,12910,10496,-3158
ISNE,"7/30/2016 4 a.m. EDT",13472,12540,10369,-3103
ISNE,"7/30/2016 5 a.m. EDT",13546,12400,10516,-3030
ISNE,"7/30/2016 6 a.m. EDT",13648,12560,10616,-3032
ISNE,"7/30/2016 7 a.m. EDT",13832,12970,10975,-2857
ISNE,"7/30/2016 8 a.m. EDT",14338,13900,11949,-2389
ISNE,"7/30/2016 9 a.m. EDT",15354,15040,12608,-2746
ISNE,"7/30/2016 10 a.m. EDT",15963,15950,13472,-2491
ISNE,"7/30/2016 11 a.m. EDT",16764,16660,14388,-2376
ISNE,"7/30/2016 12 p.m. EDT",17417,17170,14975,-2442
ISNE,"7/30/2016 1 p.m. EDT",18018,17490,15554,-2464
ISNE,"7/30/2016 2 p.m. EDT",18453,17700,15957,-2496
ISNE,"7/30/2016 3 p.m. EDT",18707,18140,15933,-2774
ISNE,"7/30/2016 4 p.m. EDT",18875,18470,15873,-3002
ISNE,"7/30/2016 5 p.m. EDT",19052,18770,15990,-3062
ISNE,"7/30/2016 6 p.m. EDT",19122,18970,16176,-2946
ISNE,"7/30/2016 7 p.m. EDT",18756,18680,15558,-3198
ISNE,"7/30/2016 8 p.m. EDT",18296,18070,14844,-3452
ISNE,"7/30/2016 9 p.m. EDT",18198,17830,14807,-3391
ISNE,"7/30/2016 10 p.m. EDT",17605,17220,14360,-3245
ISNE,"7/30/2016 11 p.m. EDT",16476,16120,13452,-3024
ISNE,"7/31/2016 12 a.m. EDT",15260,14830,12271,-2989
ISNE,"7/31/2016 1 a.m. EDT",14507,13760,11832,-2675
ISNE,"7/31/2016 2 a.m. EDT",14018,13000,11442,-2576
ISNE,"7/31/2016 3 a.m. EDT",14026,12520,11567,-2459
ISNE,"7/31/2016 4 a.m. EDT",13792,12190,11271,-2521
ISNE,"7/31/2016 5 a.m. EDT",13845,12090,11204,-2641
ISNE,"7/31/2016 6 a.m. EDT",13937,12660,11367,-2570
ISNE,"7/31/2016 7 a.m. EDT",13924,12910,11184,-2740
ISNE,"7/31/2016 8 a.m. EDT",13906,13460,11097,-2809
ISNE,"7/31/2016 9 a.m. EDT",14308,14280,11628,-2680
ISNE,"7/31/2016 10 a.m. EDT",15034,15250,12451,-2583
ISNE,"7/31/2016 11 a.m. EDT",15581,15680,13128,-2453
ISNE,"7/31/2016 12 p.m. EDT",15943,16140,13611,-2332
ISNE,"7/31/2016 1 p.m. EDT",16138,16420,13994,-2144
ISNE,"7/31/2016 2 p.m. EDT",16227,16570,13906,-2321
ISNE,"7/31/2016 3 p.m. EDT",16310,16820,13949,-2361
ISNE,"7/31/2016 4 p.m. EDT",16452,16890,14196,-2256
ISNE,"7/31/2016 5 p.m. EDT",16755,17220,14459,-2296
ISNE,"7/31/2016 6 p.m. EDT",17025,17490,14651,-2374
ISNE,"7/31/2016 7 p.m. EDT",16986,17540,14568,-2418
ISNE,"7/31/2016 8 p.m. EDT",16858,17090,14295,-2563
ISNE,"7/31/2016 9 p.m. EDT",16864,16980,14342,-2522
ISNE,"7/31/2016 10 p.m. EDT",16245,16330,13522,-2723
ISNE,"7/31/2016 11 p.m. EDT",15025,15160,12296,-2729
ISNE,"8/1/2016 12 a.m. EDT",13794,13900,11208,-2586
