"BA Code","Timestamp (Hour Ending)","Demand (MWh)","Demand Forecast (MWh)","Net Generation (MWh)","Total Interchange (MWh)"
ISNE,"10/1/2016 12 a.m. EDT",10865,10980,9808,-1057
ISNE,"10/1/2016 1 a.m. EDT",10275,10180,9156,-1119
ISNE,"10/1/2016 2 a.m. EDT",9975,9700,8923,-1052
ISNE,"10/1/2016 3 a.m. EDT",10106,9460,9034,-1072
ISNE,"10/1/2016 4 a.m. EDT",9990,9240,8936,-1054
ISNE,"10/1/2016 5 a.m. EDT",10024,9300,8995,-1029
ISNE,"10/1/2016 6 a.m. EDT",10083,9600,9010,-1073
ISNE,"10/1/2016 7 a.m. EDT",10313,10240,9348,-965
ISNE,"10/1/2016 8 a.m. EDT",11117,11000,10320,-797
ISNE,"10/1/2016 9 a.m. EDT",12094,12060,11284,-810
ISNE,"10/1/2016 10 a.m. EDT",12776,12610,11957,-819
ISNE,"10/1/2016 11 a.m. EDT",13098,12870,12273,-825
ISNE,"10/1/2016 12 p.m. EDT",13177,12930,12370,-807
ISNE,"10/1/2016 1 p.m. EDT",13070,12910,12169,-901
ISNE,"10/1/2016 2 p.m. EDT",12926,12700,12042,-884
ISNE,"10/1/2016 3 p.m. EDT",12793,12520,11907,-886
ISNE,"10/1/2016 4 p.m. EDT",12775,12650,11865,-910
ISNE,"10/1/2016 5 p.m. EDT",12889,12840,11903,-986
ISNE,"10/1/2016 6 p.m. EDT",13160,13180,11921,-1239
ISNE,"10/1/2016 7 p.m. EDT",13567,13700,12130,-1437
ISNE,"10/1/2016 8 p.m. EDT",13575,13690,11944,-1631
ISNE,"10/1/2016 9 p.m. EDT",13120,13110,11845,-1275
ISNE,"10/1/2016 10 p.m. EDT",12439,12370,11414,-1025
ISNE,"10/1/2016 11 p.m. EDT",11776,11520,10542,-1234
ISNE,"10/2/2016 12 a.m. EDT",11067,10590,10009,-1058
ISNE,"10/2/2016 1 a.m. EDT",10411,9940,8883,-1528
ISNE,"10/2/2016 2 a.m. EDT",10156,9410,8579,-1577
ISNE,"10/2/2016 3 a.m. EDT",9875,9130,8211,-1664
ISNE,"10/2/2016 4 a.m. EDT",9743,8940,8161,-1582
ISNE,"10/2/2016 5 a.m. EDT",10025,8970,8400,-1625
ISNE,"10/2/2016 6 a.m. EDT",10030,9250,8399,-1631
ISNE,"10/2/2016 7 a.m. EDT",10485,9710,8795,-1690
ISNE,"10/2/2016 8 a.m. EDT",10996,10250,9464,-1532
ISNE,"10/2/2016 9 a.m. EDT",11432,11120,10049,-1383
ISNE,"10/2/2016 10 a.m. EDT",12018,11760,10756,-1262
ISNE,"10/2/2016 11 a.m. EDT",12405,12330,10874,-1531
ISNE,"10/2/2016 12 p.m. EDT",12622,12530,11098,-1524
ISNE,"10/2/2016 1 p.m. EDT",12790,12530,11275,-1515
ISNE,"10/2/2016 2 p.m. EDT",12825,12360,11271,-1554
ISNE,"10/2/2016 3 p.m. EDT",12782,12800,11106,-1676
ISNE,"10/2/2016 4 p.m. EDT",12814,12750,11031,-1783
ISNE,"10/2/2016 5 p.m. EDT",13106,13120,11418,-1688
ISNE,"10/2/2016 6 p.m. EDT",13545,13380,11812,-1733
ISNE,"10/2/2016 7 p.m. EDT",14038,13960,12085,-1953
ISNE,"10/2/2016 8 p.m. EDT",14078,13970,12109,-1969
ISNE,"10/2/2016 9 p.m. EDT",13465,13540,11566,-1899
ISNE,"10/2/2016 10 p.m. EDT",12494,12640,10687,-1807
ISNE,"10/2/2016 11 p.m. EDT",11393,11490,9286,-2107
ISNE,"10/3/2016 12 a.m. EDT",10656,10480,8720,-1936
ISNE,"10/3/2016 1 a.m. EDT",10509,9700,8635,-1874
ISNE,"10/3/2016 2 a.m. EDT",10183,9260,8364,-1819
ISNE,"10/3/2016 3 a.m. EDT",10008,9110,8154,-1854
ISNE,"10/3/2016 4 a.m. EDT",9995,9150,8178,-1817
ISNE,"10/3/2016 5 a.m. EDT",10379,9520,8470,-1909
ISNE,"10/3/2016 6 a.m. EDT",11002,10550,9056,-1946
ISNE,"10/3/2016 7 a.m. EDT",12188,12340,10329,-1859
ISNE,"10/3/2016 8 a.m. EDT",13278,13390,11099,-2179
ISNE,"10/3/2016 9 a.m. EDT",13690,13670,11522,-2168
ISNE,"10/3/2016 10 a.m. EDT",13887,13920,11726,-2161
ISNE,"10/3/2016 11 a.m. EDT",13971,14110,11757,-2214
ISNE,"10/3/2016 12 p.m. EDT",14049,14230,11870,-2179
ISNE,"10/3/2016 1 p.m. EDT",14157,14230,12243,-1914
ISNE,"10/3/2016 2 p.m. EDT",14307,14350,12305,-2002
ISNE,"10/3/2016 3 p.m. EDT",14384,14390,12423,-1961
ISNE,"10/3/2016 4 p.m. EDT",14425,14310,12544,-1881
ISNE,"10/3/2016 5 p.m. EDT",14557,14470,12552,-2005
ISNE,"10/3/2016 6 p.m. EDT",14866,14760,12773,-2093
ISNE,"10/3/2016 7 p.m. EDT",15344,15310,12997,-2347
ISNE,"10/3/2016 8 p.m. EDT",15475,15300,13220,-2255
ISNE,"10/3/2016 9 p.m. EDT",14758,14520,12531,-2227
ISNE,"10/3/2016 10 p.m. EDT",13651,13470,11622,-2029
ISNE,"10/3/2016 11 p.m. EDT",12308,12110,10215,-2093
ISNE,"10/4/2016 12 a.m. EDT",11386,10920,9339,-2047
ISNE,"10/4/2016 1 a.m. EDT",10585,10220,8595,-1990
ISNE,"10/4/2016 2 a.m. EDT",10379,9810,8482,-1897
ISNE,"10/4/2016 3 a.m. EDT",10140,9570,8177,-1963
ISNE,"10/4/2016 4 a.m. EDT",10067,9510,8055,-2012
ISNE,"10/4/2016 5 a.m. EDT",10292,9770,8441,-1851
ISNE,"10/4/2016 6 a.m. EDT",10858,10730,9039,-1819
ISNE,"10/4/2016 7 a.m. EDT",12472,12500,10864,-1608
ISNE,"10/4/2016 8 a.m. EDT",13571,13510,11909,-1662
ISNE,"10/4/2016 9 a.m. EDT",13891,13760,12076,-1815
ISNE,"10/4/2016 10 a.m. EDT",14020,13860,12235,-1785
ISNE,"10/4/2016 11 a.m. EDT",14121,13950,12270,-1851
ISNE,"10/4/2016 12 p.m. EDT",14139,13960,12150,-1989
ISNE,"10/4/2016 1 p.m. EDT",14058,13940,12169,-1889
ISNE,"10/4/2016 2 p.m. EDT",13998,13960,12206,-1792
ISNE,"10/4/2016 3 p.m. EDT",13876,13970,12106,-1770
ISNE,"10/4/2016 4 p.m. EDT",13874,13950,12219,-1655
ISNE,"10/4/2016 5 p.m. EDT",14057,14130,12188,-1869
ISNE,"10/4/2016 6 p.m. EDT",14376,14430,12192,-2184
ISNE,"10/4/2016 7 p.m. EDT",14937,14960,13054,-1883
ISNE,"10/4/2016 8 p.m. EDT",15183,15120,13339,-1844
ISNE,"10/4/2016 9 p.m. EDT",14520,14450,12301,-2219
ISNE,"10/4/2016 10 p.m. EDT",13424,13370,11749,-1675
ISNE,"10/4/2016 11 p.m. EDT",12098,12050,10168,-1930
ISNE,"10/5/2016 12 a.m. EDT",11188,10870,9479,-1709
ISNE,"10/5/2016 1 a.m. EDT",10691,10170,8841,-1850
ISNE,"10/5/2016 2 a.m. EDT",10577,9730,8540,-2037
ISNE,"10/5/2016 3 a.m. EDT",10367,9510,8541,-1826
ISNE,"10/5/2016 4 a.m. EDT",10246,9480,8503,-1743
ISNE,"10/5/2016 5 a.m. EDT",10265,9730,8665,-1600
ISNE,"10/5/2016 6 a.m. EDT",11071,10710,9304,-1767
ISNE,"10/5/2016 7 a.m. EDT",12502,12530,10529,-1973
ISNE,"10/5/2016 8 a.m. EDT",13446,13490,11216,-2230
ISNE,"10/5/2016 9 a.m. EDT",13543,13550,11187,-2356
ISNE,"10/5/2016 10 a.m. EDT",13471,13500,11264,-2207
ISNE,"10/5/2016 11 a.m. EDT",13427,13430,11441,-1986
ISNE,"10/5/2016 12 p.m. EDT",13366,13420,11564,-1802
ISNE,"10/5/2016 1 p.m. EDT",13371,13380,11375,-1996
ISNE,"10/5/2016 2 p.m. EDT",13507,13460,11341,-2166
ISNE,"10/5/2016 3 p.m. EDT",13548,13480,11438,-2110
ISNE,"10/5/2016 4 p.m. EDT",13658,13560,11500,-2158
ISNE,"10/5/2016 5 p.m. EDT",13954,13740,11648,-2306
ISNE,"10/5/2016 6 p.m. EDT",14368,14110,12036,-2332
ISNE,"10/5/2016 7 p.m. EDT",14899,14690,12431,-2468
ISNE,"10/5/2016 8 p.m. EDT",15128,14970,12637,-2491
ISNE,"10/5/2016 9 p.m. EDT",14476,14390,12115,-2361
ISNE,"10/5/2016 10 p.m. EDT",13421,13310,11120,-2301
ISNE,"10/5/2016 11 p.m. EDT",12096,11950,10027,-2069
ISNE,"10/6/2016 12 a.m. EDT",11515,10820,9526,-1989
ISNE,"10/6/2016 1 a.m. EDT",10915,10110,8744,-2171
ISNE,"10/6/2016 2 a.m. EDT",10476,9670,8406,-2070
ISNE,"10/6/2016 3 a.m. EDT",10262,9450,8262,-2000
ISNE,"10/6/2016 4 a.m. EDT",10230,9420,8247,-1983
ISNE,"10/6/2016 5 a.m. EDT",10507,9680,8604,-1903
ISNE,"10/6/2016 6 a.m. EDT",10904,10720,9028,-1876
ISNE,"10/6/2016 7 a.m. EDT",12506,12630,10515,-1991
ISNE,"10/6/2016 8 a.m. EDT",13502,13520,11346,-2156
ISNE,"10/6/2016 9 a.m. EDT",13620,13500,11502,-2118
ISNE,"10/6/2016 10 a.m. EDT",13542,13470,11322,-2220
ISNE,"10/6/2016 11 a.m. EDT",13518,13520,11444,-2074
ISNE,"10/6/2016 12 p.m. EDT",13479,13440,11442,-2037
ISNE,"10/6/2016 1 p.m. EDT",13494,13430,11535,-1959
ISNE,"10/6/2016 2 p.m. EDT",13670,13660,11831,-1839
ISNE,"10/6/2016 3 p.m. EDT",13753,13700,11898,-1855
ISNE,"10/6/2016 4 p.m. EDT",13914,13800,12033,-1881
ISNE,"10/6/2016 5 p.m. EDT",14245,14010,12336,-1909
ISNE,"10/6/2016 6 p.m. EDT",14593,14280,12643,-1950
ISNE,"10/6/2016 7 p.m. EDT",15036,14790,12899,-2137
ISNE,"10/6/2016 8 p.m. EDT",15192,15130,13254,-1938
ISNE,"10/6/2016 9 p.m. EDT",14568,14370,12050,-2518
ISNE,"10/6/2016 10 p.m. EDT",13511,13350,10443,-3068
ISNE,"10/6/2016 11 p.m. EDT",12204,11980,9030,-3174
ISNE,"10/7/2016 12 a.m. EDT",11319,10840,8438,-2881
ISNE,"10/7/2016 1 a.m. EDT",10953,10070,8062,-2891
ISNE,"10/7/2016 2 a.m. EDT",10947,9600,7976,-2971
ISNE,"10/7/2016 3 a.m. EDT",10820,9360,8093,-2727
ISNE,"10/7/2016 4 a.m. EDT",10756,9340,8036,-2720
ISNE,"10/7/2016 5 a.m. EDT",10726,9670,8072,-2654
ISNE,"10/7/2016 6 a.m. EDT",11061,10660,8671,-2390
ISNE,"10/7/2016 7 a.m. EDT",12259,12480,9860,-2399
ISNE,"10/7/2016 8 a.m. EDT",13238,13340,10481,-2757
ISNE,"10/7/2016 9 a.m. EDT",13487,13430,10834,-2653
ISNE,"10/7/2016 10 a.m. EDT",13528,13440,11021,-2507
ISNE,"10/7/2016 11 a.m. EDT",13645,13620,11237,-2408
ISNE,"10/7/2016 12 p.m. EDT",13727,13710,10930,-2797
ISNE,"10/7/2016 1 p.m. EDT",13717,13570,10938,-2779
ISNE,"10/7/2016 2 p.m. EDT",13845,13750,11089,-2756
ISNE,"10/7/2016 3 p.m. EDT",13911,13810,11204,-2707
ISNE,"10/7/2016 4 p.m. EDT",13970,14000,11254,-2716
ISNE,"10/7/2016 5 p.m. EDT",14174,14060,11446,-2728
ISNE,"10/7/2016 6 p.m. EDT",14388,14300,11531,-2857
ISNE,"10/7/2016 7 p.m. EDT",14657,14430,11790,-2867
ISNE,"10/7/2016 8 p.m. EDT",14638,14610,11566,-3072
ISNE,"10/7/2016 9 p.m. EDT",13990,14070,11060,-2930
ISNE,"10/7/2016 10 p.m. EDT",13153,13220,10224,-2929
ISNE,"10/7/2016 11 p.m. EDT",12081,12010,9316,-2765
ISNE,"10/8/2016 12 a.m. EDT",11263,10990,8812,-2451
ISNE,"10/8/2016 1 a.m. EDT",10675,10150,7906,-2769
ISNE,"10/8/2016 2 a.m. EDT",10369,9670,7561,-2808
ISNE,"10/8/2016 3 a.m. EDT",10378,9380,7697,-2681
ISNE,"10/8/2016 4 a.m. EDT",10264,9240,7727,-2537
ISNE,"10/8/2016 5 a.m. EDT",10139,9320,7745,-2394
ISNE,"10/8/2016 6 a.m. EDT",10492,9630,7919,-2573
ISNE,"10/8/2016 7 a.m. EDT",10640,10380,8169,-2471
ISNE,"10/8/2016 8 a.m. EDT",11168,11100,8494,-2674
ISNE,"10/8/2016 9 a.m. EDT",11682,11880,8955,-2727
ISNE,"10/8/2016 10 a.m. EDT",12179,12310,9595,-2584
ISNE,"10/8/2016 11 a.m. EDT",12367,12460,9992,-2375
ISNE,"10/8/2016 12 p.m. EDT",12340,12530,9996,-2344
ISNE,"10/8/2016 1 p.m. EDT",12385,12510,10035,-2350
ISNE,"10/8/2016 2 p.m. EDT",12517,12430,10181,-2336
ISNE,"10/8/2016 3 p.m. EDT",12554,12460,10189,-2365
ISNE,"10/8/2016 4 p.m. EDT",12650,12540,10147,-2503
ISNE,"10/8/2016 5 p.m. EDT",12873,12830,10280,-2593
ISNE,"10/8/2016 6 p.m. EDT",13312,13170,10604,-2708
ISNE,"10/8/2016 7 p.m. EDT",13935,13800,11272,-2663
ISNE,"10/8/2016 8 p.m. EDT",13867,13790,11287,-2580
ISNE,"10/8/2016 9 p.m. EDT",13410,13330,11177,-2233
ISNE,"10/8/2016 10 p.m. EDT",12749,12590,10515,-2234
ISNE,"10/8/2016 11 p.m. EDT",11874,11710,9774,-2100
ISNE,"10/9/2016 12 a.m. EDT",10952,10780,9213,-1739
ISNE,"10/9/2016 1 a.m. EDT",10451,10030,8462,-1989
ISNE,"10/9/2016 2 a.m. EDT",10063,9520,7907,-2156
ISNE,"10/9/2016 3 a.m. EDT",9972,9220,7813,-2159
ISNE,"10/9/2016 4 a.m. EDT",9823,9040,7830,-1993
ISNE,"10/9/2016 5 a.m. EDT",10066,9000,8061,-2005
ISNE,"10/9/2016 6 a.m. EDT",10233,9420,8182,-2051
ISNE,"10/9/2016 7 a.m. EDT",10397,9780,8033,-2364
ISNE,"10/9/2016 8 a.m. EDT",10840,10350,8317,-2523
ISNE,"10/9/2016 9 a.m. EDT",11426,11310,8627,-2799
ISNE,"10/9/2016 10 a.m. EDT",12279,11940,9599,-2680
ISNE,"10/9/2016 11 a.m. EDT",12801,12650,9981,-2820
ISNE,"10/9/2016 12 p.m. EDT",13114,12900,10194,-2920
ISNE,"10/9/2016 1 p.m. EDT",13299,13060,10128,-3171
ISNE,"10/9/2016 2 p.m. EDT",13238,13120,9935,-3303
ISNE,"10/9/2016 3 p.m. EDT",13101,13010,9809,-3292
ISNE,"10/9/2016 4 p.m. EDT",13056,13000,9903,-3153
ISNE,"10/9/2016 5 p.m. EDT",13245,13380,10260,-2985
ISNE,"10/9/2016 6 p.m. EDT",13580,13850,10617,-2963
ISNE,"10/9/2016 7 p.m. EDT",13891,14430,10916,-2975
ISNE,"10/9/2016 8 p.m. EDT",13763,14500,10658,-3105
ISNE,"10/9/2016 9 p.m. EDT",13214,13770,10146,-3068
ISNE,"10/9/2016 10 p.m. EDT",12315,12960,9527,-2788
ISNE,"10/9/2016 11 p.m. EDT",11557,11850,8911,-2646
ISNE,"10/10/2016 12 a.m. EDT",10890,10880,8651,-2239
ISNE,"10/10/2016 1 a.m. EDT",10541,10000,8831,-1710
ISNE,"10/10/2016 2 a.m. EDT",10157,9520,8733,-1424
ISNE,"10/10/2016 3 a.m. EDT",10123,9300,8871,-1252
ISNE,"10/10/2016 4 a.m. EDT",10060,9200,8780,-1280
ISNE,"10/10/2016 5 a.m. EDT",10303,9370,8988,-1315
ISNE,"10/10/2016 6 a.m. EDT",10864,10140,9067,-1797
ISNE,"10/10/2016 7 a.m. EDT",11682,11400,9271,-2411
ISNE,"10/10/2016 8 a.m. EDT",12465,12390,9772,-2693
ISNE,"10/10/2016 9 a.m. EDT",12770,13020,10080,-2690
ISNE,"10/10/2016 10 a.m. EDT",12939,13240,10187,-2752
ISNE,"10/10/2016 11 a.m. EDT",12910,13260,10275,-2635
ISNE,"10/10/2016 12 p.m. EDT",12791,13210,10208,-2583
ISNE,"10/10/2016 1 p.m. EDT",12647,13090,10155,-2492
ISNE,"10/10/2016 2 p.m. EDT",12573,12940,10009,-2564
ISNE,"10/10/2016 3 p.m. EDT",12555,12920,9999,-2556
ISNE,"10/10/2016 4 p.m. EDT",12701,12960,10252,-2449
ISNE,"10/10/2016 5 p.m. EDT",13207,13220,10640,-2567
ISNE,"10/10/2016 6 p.m. EDT",13983,13910,11122,-2861
ISNE,"10/10/2016 7 p.m. EDT",14766,14900,11977,-2789
ISNE,"10/10/2016 8 p.m. EDT",14924,15130,11999,-2925
ISNE,"10/10/2016 9 p.m. EDT",14304,14460,11563,-2741
ISNE,"10/10/2016 10 p.m. EDT",13282,13330,10591,-2691
ISNE,"10/10/2016 11 p.m. EDT",12009,12030,9358,-2651
ISNE,"10/11/2016 12 a.m. EDT",10920,10910,8867,-2053
ISNE,"10/11/2016 1 a.m. EDT",10565,10260,8601,-1964
ISNE,"10/11/2016 2 a.m. EDT",10601,9850,8204,-2397
ISNE,"10/11/2016 3 a.m. EDT",10611,9640,8390,-2221
ISNE,"10/11/2016 4 a.m. EDT",10620,9630,8450,-2170
ISNE,"10/11/2016 5 a.m. EDT",10800,9920,8497,-2303
ISNE,"10/11/2016 6 a.m. EDT",11319,10890,8815,-2504
ISNE,"10/11/2016 7 a.m. EDT",12794,12750,10370,-2424
ISNE,"10/11/2016 8 a.m. EDT",13854,13630,11060,-2794
ISNE,"10/11/2016 9 a.m. EDT",13897,13660,11078,-2819
ISNE,"10/11/2016 10 a.m. EDT",13612,13440,10795,-2817
ISNE,"10/11/2016 11 a.m. EDT",13423,13280,10620,-2803
ISNE,"10/11/2016 12 p.m. EDT",13294,13130,10459,-2835
ISNE,"10/11/2016 1 p.m. EDT",13152,12990,10520,-2632
ISNE,"10/11/2016 2 p.m. EDT",13191,12970,10500,-2691
ISNE,"10/11/2016 3 p.m. EDT",13175,13010,10253,-2922
ISNE,"10/11/2016 4 p.m. EDT",13316,13070,10471,-2845
ISNE,"10/11/2016 5 p.m. EDT",13693,13350,10908,-2785
ISNE,"10/11/2016 6 p.m. EDT",14272,13940,11057,-3215
ISNE,"10/11/2016 7 p.m. EDT",15091,14750,11974,-3117
ISNE,"10/11/2016 8 p.m. EDT",15140,15000,11786,-3354
ISNE,"10/11/2016 9 p.m. EDT",14470,14390,11337,-3133
ISNE,"10/11/2016 10 p.m. EDT",13421,13320,10659,-2762
ISNE,"10/11/2016 11 p.m. EDT",12100,11890,9127,-2973
ISNE,"10/12/2016 12 a.m. EDT",10977,10800,8574,-2403
ISNE,"10/12/2016 1 a.m. EDT",10580,10090,8189,-2391
ISNE,"10/12/2016 2 a.m. EDT",10822,9680,8133,-2689
ISNE,"10/12/2016 3 a.m. EDT",10854,9490,8088,-2766
ISNE,"10/12/2016 4 a.m. EDT",10897,9460,8021,-2876
ISNE,"10/12/2016 5 a.m. EDT",10942,9770,8179,-2763
ISNE,"10/12/2016 6 a.m. EDT",11410,10700,8824,-2586
ISNE,"10/12/2016 7 a.m. EDT",12655,12520,10180,-2475
ISNE,"10/12/2016 8 a.m. EDT",13600,13420,10734,-2866
ISNE,"10/12/2016 9 a.m. EDT",13726,13410,10775,-2951
ISNE,"10/12/2016 10 a.m. EDT",13592,13360,10707,-2885
ISNE,"10/12/2016 11 a.m. EDT",13506,13500,10808,-2698
ISNE,"10/12/2016 12 p.m. EDT",13404,13390,10834,-2570
ISNE,"10/12/2016 1 p.m. EDT",13310,13300,10768,-2542
ISNE,"10/12/2016 2 p.m. EDT",13367,13390,10822,-2545
ISNE,"10/12/2016 3 p.m. EDT",13376,13430,10822,-2554
ISNE,"10/12/2016 4 p.m. EDT",13512,13530,10837,-2675
ISNE,"10/12/2016 5 p.m. EDT",13842,13840,11004,-2838
ISNE,"10/12/2016 6 p.m. EDT",14353,14300,11260,-3093
ISNE,"10/12/2016 7 p.m. EDT",15065,14960,11797,-3268
ISNE,"10/12/2016 8 p.m. EDT",15120,15100,11968,-3152
ISNE,"10/12/2016 9 p.m. EDT",14448,14430,11230,-3218
ISNE,"10/12/2016 10 p.m. EDT",13382,13360,10506,-2876
ISNE,"10/12/2016 11 p.m. EDT",12053,12020,9268,-2785
ISNE,"10/13/2016 12 a.m. EDT",10900,10870,8215,-2685
ISNE,"10/13/2016 1 a.m. EDT",10668,10150,7754,-2914
ISNE,"10/13/2016 2 a.m. EDT",10507,9700,7543,-2964
ISNE,"10/13/2016 3 a.m. EDT",10513,9490,7548,-2965
ISNE,"10/13/2016 4 a.m. EDT",10544,9460,7530,-3014
ISNE,"10/13/2016 5 a.m. EDT",10813,9750,7972,-2841
ISNE,"10/13/2016 6 a.m. EDT",11244,10720,8586,-2658
ISNE,"10/13/2016 7 a.m. EDT",12564,12560,9774,-2790
ISNE,"10/13/2016 8 a.m. EDT",13586,13510,10585,-3001
ISNE,"10/13/2016 9 a.m. EDT",13790,13710,10701,-3089
ISNE,"10/13/2016 10 a.m. EDT",13862,13740,10555,-3307
ISNE,"10/13/2016 11 a.m. EDT",13942,13830,10824,-3118
ISNE,"10/13/2016 12 p.m. EDT",13919,13820,10839,-3080
ISNE,"10/13/2016 1 p.m. EDT",13846,13800,10849,-2997
ISNE,"10/13/2016 2 p.m. EDT",14033,13910,11051,-2982
ISNE,"10/13/2016 3 p.m. EDT",14191,13860,11275,-2916
ISNE,"10/13/2016 4 p.m. EDT",14279,13940,11209,-3070
ISNE,"10/13/2016 5 p.m. EDT",14416,14200,11269,-3147
ISNE,"10/13/2016 6 p.m. EDT",14813,14520,11654,-3159
ISNE,"10/13/2016 7 p.m. EDT",15344,15100,12254,-3090
ISNE,"10/13/2016 8 p.m. EDT",15214,15200,12023,-3191
ISNE,"10/13/2016 9 p.m. EDT",14545,14450,11427,-3118
ISNE,"10/13/2016 10 p.m. EDT",13474,13400,10590,-2884
ISNE,"10/13/2016 11 p.m. EDT",12112,12110,9360,-2752
ISNE,"10/14/2016 12 a.m. EDT",11303,10930,8695,-2608
ISNE,"10/14/2016 1 a.m. EDT",10943,10180,8349,-2594
ISNE,"10/14/2016 2 a.m. EDT",10723,9760,8194,-2529
ISNE,"10/14/2016 3 a.m. EDT",10632,9540,7919,-2713
ISNE,"10/14/2016 4 a.m. EDT",10716,9510,8009,-2707
ISNE,"10/14/2016 5 a.m. EDT",10769,9790,8083,-2686
ISNE,"10/14/2016 6 a.m. EDT",11232,10610,8476,-2756
ISNE,"10/14/2016 7 a.m. EDT",12405,12450,10007,-2398
ISNE,"10/14/2016 8 a.m. EDT",13455,13410,10904,-2551
ISNE,"10/14/2016 9 a.m. EDT",13579,13590,10869,-2710
ISNE,"10/14/2016 10 a.m. EDT",13365,13460,10618,-2747
ISNE,"10/14/2016 11 a.m. EDT",13204,13330,10452,-2752
ISNE,"10/14/2016 12 p.m. EDT",13031,13180,10314,-2717
ISNE,"10/14/2016 1 p.m. EDT",12842,13040,10092,-2750
ISNE,"10/14/2016 2 p.m. EDT",12840,13020,10017,-2823
ISNE,"10/14/2016 3 p.m. EDT",12806,13060,9936,-2870
ISNE,"10/14/2016 4 p.m. EDT",12926,13110,10176,-2750
ISNE,"10/14/2016 5 p.m. EDT",13275,13260,10515,-2760
ISNE,"10/14/2016 6 p.m. EDT",13757,13710,10995,-2762
ISNE,"10/14/2016 7 p.m. EDT",14399,14250,11043,-3356
ISNE,"10/14/2016 8 p.m. EDT",14362,14290,11092,-3270
ISNE,"10/14/2016 9 p.m. EDT",13842,13840,10759,-3083
ISNE,"10/14/2016 10 p.m. EDT",13098,13030,10160,-2938
ISNE,"10/14/2016 11 p.m. EDT",12108,12040,9071,-3037
ISNE,"10/15/2016 12 a.m. EDT",11297,11020,8494,-2803
ISNE,"10/15/2016 1 a.m. EDT",10796,10300,7748,-3048
ISNE,"10/15/2016 2 a.m. EDT",10363,9870,7531,-2832
ISNE,"10/15/2016 3 a.m. EDT",10148,9590,7266,-2882
ISNE,"10/15/2016 4 a.m. EDT",10078,9540,7317,-2761
ISNE,"10/15/2016 5 a.m. EDT",10179,9580,7204,-2975
ISNE,"10/15/2016 6 a.m. EDT",10542,10030,7648,-2894
ISNE,"10/15/2016 7 a.m. EDT",10893,10830,8146,-2747
ISNE,"10/15/2016 8 a.m. EDT",11677,11510,9044,-2633
ISNE,"10/15/2016 9 a.m. EDT",12279,12140,9593,-2686
ISNE,"10/15/2016 10 a.m. EDT",12364,12200,9707,-2657
ISNE,"10/15/2016 11 a.m. EDT",12200,12250,9404,-2796
ISNE,"10/15/2016 12 p.m. EDT",11969,12090,9012,-2957
ISNE,"10/15/2016 1 p.m. EDT",11717,11900,8966,-2751
ISNE,"10/15/2016 2 p.m. EDT",11743,11710,9077,-2666
ISNE,"10/15/2016 3 p.m. EDT",11715,11670,9517,-2198
ISNE,"10/15/2016 4 p.m. EDT",11885,11790,9672,-2213
ISNE,"10/15/2016 5 p.m. EDT",12283,12160,10140,-2143
ISNE,"10/15/2016 6 p.m. EDT",12637,12780,10147,-2490
ISNE,"10/15/2016 7 p.m. EDT",13480,13510,10631,-2849
ISNE,"10/15/2016 8 p.m. EDT",13513,13500,10443,-3070
ISNE,"10/15/2016 9 p.m. EDT",13079,13090,10168,-2911
ISNE,"10/15/2016 10 p.m. EDT",12452,12410,9801,-2651
ISNE,"10/15/2016 11 p.m. EDT",11612,11550,8985,-2627
ISNE,"10/16/2016 12 a.m. EDT",10716,10680,8059,-2657
ISNE,"10/16/2016 1 a.m. EDT",9997,10040,7543,-2454
ISNE,"10/16/2016 2 a.m. EDT",9803,9580,7526,-2277
ISNE,"10/16/2016 3 a.m. EDT",9594,9350,7549,-2045
ISNE,"10/16/2016 4 a.m. EDT",9507,9260,7725,-1782
ISNE,"10/16/2016 5 a.m. EDT",9544,9320,7698,-1846
ISNE,"10/16/2016 6 a.m. EDT",9813,9520,7601,-2212
ISNE,"10/16/2016 7 a.m. EDT",10338,10030,7993,-2345
ISNE,"10/16/2016 8 a.m. EDT",10924,10670,8281,-2643
ISNE,"10/16/2016 9 a.m. EDT",11333,11260,8842,-2491
ISNE,"10/16/2016 10 a.m. EDT",11683,11640,9296,-2387
ISNE,"10/16/2016 11 a.m. EDT",11812,11820,9808,-2004
ISNE,"10/16/2016 12 p.m. EDT",11834,11890,9816,-2018
ISNE,"10/16/2016 1 p.m. EDT",11894,11860,9961,-1933
ISNE,"10/16/2016 2 p.m. EDT",11879,11890,9900,-1979
ISNE,"10/16/2016 3 p.m. EDT",11889,11940,9970,-1919
ISNE,"10/16/2016 4 p.m. EDT",12082,12150,10165,-1917
ISNE,"10/16/2016 5 p.m. EDT",12542,12740,10557,-1985
ISNE,"10/16/2016 6 p.m. EDT",13268,13320,11081,-2187
ISNE,"10/16/2016 7 p.m. EDT",14171,14210,11519,-2652
ISNE,"10/16/2016 8 p.m. EDT",14103,14050,11603,-2500
ISNE,"10/16/2016 9 p.m. EDT",13490,13450,11366,-2124
ISNE,"10/16/2016 10 p.m. EDT",12519,12500,10578,-1941
ISNE,"10/16/2016 11 p.m. EDT",11400,11450,9414,-1986
ISNE,"10/17/2016 12 a.m. EDT",10415,10490,8459,-1956
ISNE,"10/17/2016 1 a.m. EDT",10173,9870,8089,-2084
ISNE,"10/17/2016 2 a.m. EDT",9899,9470,8018,-1881
ISNE,"10/17/2016 3 a.m. EDT",9754,9280,7983,-1771
ISNE,"10/17/2016 4 a.m. EDT",9749,9290,8035,-1714
ISNE,"10/17/2016 5 a.m. EDT",9972,9590,8279,-1693
ISNE,"10/17/2016 6 a.m. EDT",10770,10620,9093,-1677
ISNE,"10/17/2016 7 a.m. EDT",12372,12430,10461,-1911
ISNE,"10/17/2016 8 a.m. EDT",13442,13530,11601,-1841
ISNE,"10/17/2016 9 a.m. EDT",13678,13700,12010,-1668
ISNE,"10/17/2016 10 a.m. EDT",13822,13860,12275,-1547
ISNE,"10/17/2016 11 a.m. EDT",13997,14140,12457,-1540
ISNE,"10/17/2016 12 p.m. EDT",14227,14340,12633,-1594
ISNE,"10/17/2016 1 p.m. EDT",14289,14320,12517,-1772
ISNE,"10/17/2016 2 p.m. EDT",14412,14550,12735,-1677
ISNE,"10/17/2016 3 p.m. EDT",14624,14610,13042,-1582
ISNE,"10/17/2016 4 p.m. EDT",14718,14730,13132,-1586
ISNE,"10/17/2016 5 p.m. EDT",14941,14920,13322,-1619
ISNE,"10/17/2016 6 p.m. EDT",15360,15330,13359,-2001
ISNE,"10/17/2016 7 p.m. EDT",15959,15940,14067,-1892
ISNE,"10/17/2016 8 p.m. EDT",15735,15760,13929,-1806
ISNE,"10/17/2016 9 p.m. EDT",14977,14950,13024,-1953
ISNE,"10/17/2016 10 p.m. EDT",13876,13820,11802,-2074
ISNE,"10/17/2016 11 p.m. EDT",12619,12480,10631,-1988
ISNE,"10/18/2016 12 a.m. EDT",11585,11220,9978,-1607
ISNE,"10/18/2016 1 a.m. EDT",11162,10320,9651,-1511
ISNE,"10/18/2016 2 a.m. EDT",11062,9880,9455,-1607
ISNE,"10/18/2016 3 a.m. EDT",10834,9650,9081,-1753
ISNE,"10/18/2016 4 a.m. EDT",10764,9620,9110,-1654
ISNE,"10/18/2016 5 a.m. EDT",10984,9930,9120,-1864
ISNE,"10/18/2016 6 a.m. EDT",11269,10980,9378,-1891
ISNE,"10/18/2016 7 a.m. EDT",12611,12860,10679,-1932
ISNE,"10/18/2016 8 a.m. EDT",13700,13900,11822,-1878
ISNE,"10/18/2016 9 a.m. EDT",14026,14130,12309,-1717
ISNE,"10/18/2016 10 a.m. EDT",14226,14340,12497,-1729
ISNE,"10/18/2016 11 a.m. EDT",14394,14660,12653,-1741
ISNE,"10/18/2016 12 p.m. EDT",14472,14870,12716,-1756
ISNE,"10/18/2016 1 p.m. EDT",14455,15040,12645,-1810
ISNE,"10/18/2016 2 p.m. EDT",14548,15300,12702,-1846
ISNE,"10/18/2016 3 p.m. EDT",14590,15450,12688,-1902
ISNE,"10/18/2016 4 p.m. EDT",14737,15680,12763,-1974
ISNE,"10/18/2016 5 p.m. EDT",15002,15930,13076,-1926
ISNE,"10/18/2016 6 p.m. EDT",15292,16400,13319,-1973
ISNE,"10/18/2016 7 p.m. EDT",15903,17000,13907,-1996
ISNE,"10/18/2016 8 p.m. EDT",15762,16600,13828,-1934
ISNE,"10/18/2016 9 p.m. EDT",15066,15690,13105,-1961
ISNE,"10/18/2016 10 p.m. EDT",13998,14480,12437,-1561
ISNE,"10/18/2016 11 p.m. EDT",12866,13000,11020,-1846
ISNE,"10/19/2016 12 a.m. EDT",12143,11770,10002,-2141
ISNE,"10/19/2016 1 a.m. EDT",11494,11000,9366,-2128
ISNE,"10/19/2016 2 a.m. EDT",11248,10560,9238,-2010
ISNE,"10/19/2016 3 a.m. EDT",11052,10210,9055,-1997
ISNE,"10/19/2016 4 a.m. EDT",10966,10140,9053,-1913
ISNE,"10/19/2016 5 a.m. EDT",11221,10220,9217,-2004
ISNE,"10/19/2016 6 a.m. EDT",11744,11220,10006,-1738
ISNE,"10/19/2016 7 a.m. EDT",13034,13140,11152,-1882
ISNE,"10/19/2016 8 a.m. EDT",14061,14300,12305,-1756
ISNE,"10/19/2016 9 a.m. EDT",14385,14570,12279,-2106
ISNE,"10/19/2016 10 a.m. EDT",14612,14790,12422,-2190
ISNE,"10/19/2016 11 a.m. EDT",14875,15140,12579,-2296
ISNE,"10/19/2016 12 p.m. EDT",14931,15300,13039,-1892
ISNE,"10/19/2016 1 p.m. EDT",14927,15250,12695,-2232
ISNE,"10/19/2016 2 p.m. EDT",15090,15470,12717,-2373
ISNE,"10/19/2016 3 p.m. EDT",15144,15570,12867,-2277
ISNE,"10/19/2016 4 p.m. EDT",15207,15750,13062,-2145
ISNE,"10/19/2016 5 p.m. EDT",15388,15860,13255,-2133
ISNE,"10/19/2016 6 p.m. EDT",15500,16300,13230,-2270
ISNE,"10/19/2016 7 p.m. EDT",15946,16800,13548,-2398
ISNE,"10/19/2016 8 p.m. EDT",15702,16280,13371,-2331
ISNE,"10/19/2016 9 p.m. EDT",14977,15260,12772,-2205
ISNE,"10/19/2016 10 p.m. EDT",13761,14220,11717,-2044
ISNE,"10/19/2016 11 p.m. EDT",12677,12850,10454,-2223
ISNE,"10/20/2016 12 a.m. EDT",11524,11370,9284,-2240
ISNE,"10/20/2016 1 a.m. EDT",10860,10490,8255,-2605
ISNE,"10/20/2016 2 a.m. EDT",10748,9990,8116,-2632
ISNE,"10/20/2016 3 a.m. EDT",10584,9720,8074,-2510
ISNE,"10/20/2016 4 a.m. EDT",10473,9620,7897,-2576
ISNE,"10/20/2016 5 a.m. EDT",10674,9670,8253,-2421
ISNE,"10/20/2016 6 a.m. EDT",11162,10620,8665,-2497
ISNE,"10/20/2016 7 a.m. EDT",12548,12490,10026,-2522
ISNE,"10/20/2016 8 a.m. EDT",13306,13560,10855,-2451
ISNE,"10/20/2016 9 a.m. EDT",13482,13780,11069,-2413
ISNE,"10/20/2016 10 a.m. EDT",13515,13960,11262,-2253
ISNE,"10/20/2016 11 a.m. EDT",13568,14080,11511,-2057
ISNE,"10/20/2016 12 p.m. EDT",13662,14050,11668,-1994
ISNE,"10/20/2016 1 p.m. EDT",13756,14050,11716,-2040
ISNE,"10/20/2016 2 p.m. EDT",13943,14120,11852,-2091
ISNE,"10/20/2016 3 p.m. EDT",13982,14120,11743,-2239
ISNE,"10/20/2016 4 p.m. EDT",13992,14220,11646,-2346
ISNE,"10/20/2016 5 p.m. EDT",14160,14560,11970,-2190
ISNE,"10/20/2016 6 p.m. EDT",14633,14920,12347,-2286
ISNE,"10/20/2016 7 p.m. EDT",15279,15600,13174,-2105
ISNE,"10/20/2016 8 p.m. EDT",15046,15410,12797,-2249
ISNE,"10/20/2016 9 p.m. EDT",14393,14670,12083,-2310
ISNE,"10/20/2016 10 p.m. EDT",13404,13580,11108,-2296
ISNE,"10/20/2016 11 p.m. EDT",12171,12270,9971,-2200
ISNE,"10/21/2016 12 a.m. EDT",11019,11140,8886,-2133
ISNE,"10/21/2016 1 a.m. EDT",10475,10250,8331,-2144
ISNE,"10/21/2016 2 a.m. EDT",10618,9750,8217,-2401
ISNE,"10/21/2016 3 a.m. EDT",10585,9560,8087,-2498
ISNE,"10/21/2016 4 a.m. EDT",10383,9510,8104,-2279
ISNE,"10/21/2016 5 a.m. EDT",10798,9820,8348,-2450
ISNE,"10/21/2016 6 a.m. EDT",11182,10780,8820,-2362
ISNE,"10/21/2016 7 a.m. EDT",12499,12550,10039,-2460
ISNE,"10/21/2016 8 a.m. EDT",13734,13580,11201,-2533
ISNE,"10/21/2016 9 a.m. EDT",14202,13890,11865,-2337
ISNE,"10/21/2016 10 a.m. EDT",14487,14100,12399,-2088
ISNE,"10/21/2016 11 a.m. EDT",14734,14360,12527,-2207
ISNE,"10/21/2016 12 p.m. EDT",14898,14400,12573,-2325
ISNE,"10/21/2016 1 p.m. EDT",14960,14360,12529,-2431
ISNE,"10/21/2016 2 p.m. EDT",15111,14380,12531,-2580
ISNE,"10/21/2016 3 p.m. EDT",15014,14320,12347,-2667
ISNE,"10/21/2016 4 p.m. EDT",14940,14360,12349,-2591
ISNE,"10/21/2016 5 p.m. EDT",14999,14430,12399,-2600
ISNE,"10/21/2016 6 p.m. EDT",15219,14700,12722,-2497
ISNE,"10/21/2016 7 p.m. EDT",15499,15400,12961,-2538
ISNE,"10/21/2016 8 p.m. EDT",15108,15120,12589,-2519
ISNE,"10/21/2016 9 p.m. EDT",14467,14300,12007,-2460
ISNE,"10/21/2016 10 p.m. EDT",13688,13410,11351,-2337
ISNE,"10/21/2016 11 p.m. EDT",12650,12350,10296,-2354
ISNE,"10/22/2016 12 a.m. EDT",11599,11270,9131,-2468
ISNE,"10/22/2016 1 a.m. EDT",10986,10360,8272,-2714
ISNE,"10/22/2016 2 a.m. EDT",10707,9820,8076,-2631
ISNE,"10/22/2016 3 a.m. EDT",10574,9580,7868,-2706
ISNE,"10/22/2016 4 a.m. EDT",10480,9350,7772,-2708
ISNE,"10/22/2016 5 a.m. EDT",10444,9320,7740,-2704
ISNE,"10/22/2016 6 a.m. EDT",10719,10020,8012,-2707
ISNE,"10/22/2016 7 a.m. EDT",11200,10800,8565,-2635
ISNE,"10/22/2016 8 a.m. EDT",11859,11500,9319,-2540
ISNE,"10/22/2016 9 a.m. EDT",12329,12300,9951,-2378
ISNE,"10/22/2016 10 a.m. EDT",12944,12810,10686,-2258
ISNE,"10/22/2016 11 a.m. EDT",13283,12960,10880,-2403
ISNE,"10/22/2016 12 p.m. EDT",13346,12970,10766,-2580
ISNE,"10/22/2016 1 p.m. EDT",13219,12850,10643,-2576
ISNE,"10/22/2016 2 p.m. EDT",12940,12620,10431,-2509
ISNE,"10/22/2016 3 p.m. EDT",12784,12560,10428,-2356
ISNE,"10/22/2016 4 p.m. EDT",12807,12550,10581,-2226
ISNE,"10/22/2016 5 p.m. EDT",12930,12840,10587,-2343
ISNE,"10/22/2016 6 p.m. EDT",13305,13220,10802,-2503
ISNE,"10/22/2016 7 p.m. EDT",13725,14000,11085,-2640
ISNE,"10/22/2016 8 p.m. EDT",13448,13710,10726,-2722
ISNE,"10/22/2016 9 p.m. EDT",12984,13210,10189,-2795
ISNE,"10/22/2016 10 p.m. EDT",12368,12510,9836,-2532
ISNE,"10/22/2016 11 p.m. EDT",11554,11690,8942,-2612
ISNE,"10/23/2016 12 a.m. EDT",10904,10860,8180,-2724
ISNE,"10/23/2016 1 a.m. EDT",10528,10120,7783,-2745
ISNE,"10/23/2016 2 a.m. EDT",10568,9730,7840,-2728
ISNE,"10/23/2016 3 a.m. EDT",10337,9450,7704,-2633
ISNE,"10/23/2016 4 a.m. EDT",10203,9340,7836,-2367
ISNE,"10/23/2016 5 a.m. EDT",10226,9380,7934,-2292
ISNE,"10/23/2016 6 a.m. EDT",10475,9550,8013,-2462
ISNE,"10/23/2016 7 a.m. EDT",10999,10040,8283,-2716
ISNE,"10/23/2016 8 a.m. EDT",11649,10790,9075,-2574
ISNE,"10/23/2016 9 a.m. EDT",11836,11480,9411,-2425
ISNE,"10/23/2016 10 a.m. EDT",11902,11820,9385,-2517
ISNE,"10/23/2016 11 a.m. EDT",11956,11860,9572,-2384
ISNE,"10/23/2016 12 p.m. EDT",11812,11900,9646,-2166
ISNE,"10/23/2016 1 p.m. EDT",11563,11860,9389,-2174
ISNE,"10/23/2016 2 p.m. EDT",11481,11720,9381,-2100
ISNE,"10/23/2016 3 p.m. EDT",11494,11670,9523,-1971
ISNE,"10/23/2016 4 p.m. EDT",11788,11870,9868,-1920
ISNE,"10/23/2016 5 p.m. EDT",12391,12360,10458,-1933
ISNE,"10/23/2016 6 p.m. EDT",13171,13240,11049,-2122
ISNE,"10/23/2016 7 p.m. EDT",14105,14300,11882,-2223
ISNE,"10/23/2016 8 p.m. EDT",13960,14070,11991,-1969
ISNE,"10/23/2016 9 p.m. EDT",13516,13580,11360,-2156
ISNE,"10/23/2016 10 p.m. EDT",12543,12660,10290,-2253
ISNE,"10/23/2016 11 p.m. EDT",11443,11610,9110,-2333
ISNE,"10/24/2016 12 a.m. EDT",10839,10610,8644,-2195
ISNE,"10/24/2016 1 a.m. EDT",10300,9780,8134,-2166
ISNE,"10/24/2016 2 a.m. EDT",9930,9450,8281,-1649
ISNE,"10/24/2016 3 a.m. EDT",9766,9290,8237,-1529
ISNE,"10/24/2016 4 a.m. EDT",9744,9300,7772,-1972
ISNE,"10/24/2016 5 a.m. EDT",10014,9640,7808,-2206
ISNE,"10/24/2016 6 a.m. EDT",10589,10690,8369,-2220
ISNE,"10/24/2016 7 a.m. EDT",12430,12590,9898,-2532
ISNE,"10/24/2016 8 a.m. EDT",13595,13660,11054,-2541
ISNE,"10/24/2016 9 a.m. EDT",13679,13790,11316,-2363
ISNE,"10/24/2016 10 a.m. EDT",13476,13720,10863,-2613
ISNE,"10/24/2016 11 a.m. EDT",13407,13630,10831,-2576
ISNE,"10/24/2016 12 p.m. EDT",13304,13540,10685,-2619
ISNE,"10/24/2016 1 p.m. EDT",13177,13440,10617,-2560
ISNE,"10/24/2016 2 p.m. EDT",13151,13370,10545,-2606
ISNE,"10/24/2016 3 p.m. EDT",13106,13360,10546,-2560
ISNE,"10/24/2016 4 p.m. EDT",13237,13460,10754,-2483
ISNE,"10/24/2016 5 p.m. EDT",13598,13850,10981,-2617
ISNE,"10/24/2016 6 p.m. EDT",14321,14590,11749,-2572
ISNE,"10/24/2016 7 p.m. EDT",15218,15500,12678,-2540
ISNE,"10/24/2016 8 p.m. EDT",15022,15250,12624,-2398
ISNE,"10/24/2016 9 p.m. EDT",14384,14690,12101,-2283
ISNE,"10/24/2016 10 p.m. EDT",13382,13620,10718,-2664
ISNE,"10/24/2016 11 p.m. EDT",12117,12350,9388,-2729
ISNE,"10/25/2016 12 a.m. EDT",11299,11210,8575,-2724
ISNE,"10/25/2016 1 a.m. EDT",10693,10410,8133,-2560
ISNE,"10/25/2016 2 a.m. EDT",10378,10040,7804,-2574
ISNE,"10/25/2016 3 a.m. EDT",10582,9850,7778,-2804
ISNE,"10/25/2016 4 a.m. EDT",10481,9830,7861,-2620
ISNE,"10/25/2016 5 a.m. EDT",10540,10160,8063,-2477
ISNE,"10/25/2016 6 a.m. EDT",11273,11160,8806,-2467
ISNE,"10/25/2016 7 a.m. EDT",12982,13170,10686,-2296
ISNE,"10/25/2016 8 a.m. EDT",14074,14190,11853,-2221
ISNE,"10/25/2016 9 a.m. EDT",14070,14200,11985,-2085
ISNE,"10/25/2016 10 a.m. EDT",13802,13980,11842,-1960
ISNE,"10/25/2016 11 a.m. EDT",13582,13860,11663,-1919
ISNE,"10/25/2016 12 p.m. EDT",13558,13730,11687,-1871
ISNE,"10/25/2016 1 p.m. EDT",13521,13630,11237,-2284
ISNE,"10/25/2016 2 p.m. EDT",13569,13590,11147,-2422
ISNE,"10/25/2016 3 p.m. EDT",13542,13580,11192,-2350
ISNE,"10/25/2016 4 p.m. EDT",13669,13740,11317,-2352
ISNE,"10/25/2016 5 p.m. EDT",14048,14230,11654,-2394
ISNE,"10/25/2016 6 p.m. EDT",14810,15010,12470,-2340
ISNE,"10/25/2016 7 p.m. EDT",15745,15900,13566,-2179
ISNE,"10/25/2016 8 p.m. EDT",15591,15680,13472,-2119
ISNE,"10/25/2016 9 p.m. EDT",15000,15040,12874,-2126
ISNE,"10/25/2016 10 p.m. EDT",13977,13990,11783,-2194
ISNE,"10/25/2016 11 p.m. EDT",12648,12700,10197,-2451
ISNE,"10/26/2016 12 a.m. EDT",11443,11550,9040,-2403
ISNE,"10/26/2016 1 a.m. EDT",11151,10730,8634,-2517
ISNE,"10/26/2016 2 a.m. EDT",10879,10340,8494,-2385
ISNE,"10/26/2016 3 a.m. EDT",10730,10140,8438,-2292
ISNE,"10/26/2016 4 a.m. EDT",10900,10170,8570,-2330
ISNE,"10/26/2016 5 a.m. EDT",11472,10520,9214,-2258
ISNE,"10/26/2016 6 a.m. EDT",11944,11680,9717,-2227
ISNE,"10/26/2016 7 a.m. EDT",13521,13680,11262,-2259
ISNE,"10/26/2016 8 a.m. EDT",14603,14580,12845,-1758
ISNE,"10/26/2016 9 a.m. EDT",14585,14380,12957,-1628
ISNE,"10/26/2016 10 a.m. EDT",14244,14110,12565,-1679
ISNE,"10/26/2016 11 a.m. EDT",13969,13900,11778,-2191
ISNE,"10/26/2016 12 p.m. EDT",13785,13710,11239,-2546
ISNE,"10/26/2016 1 p.m. EDT",13658,13530,11268,-2390
ISNE,"10/26/2016 2 p.m. EDT",13676,13480,11466,-2210
ISNE,"10/26/2016 3 p.m. EDT",13661,13520,11487,-2174
ISNE,"10/26/2016 4 p.m. EDT",13770,13650,11724,-2046
ISNE,"10/26/2016 5 p.m. EDT",14157,14160,11999,-2158
ISNE,"10/26/2016 6 p.m. EDT",14985,14940,12562,-2423
ISNE,"10/26/2016 7 p.m. EDT",15810,15930,13337,-2473
ISNE,"10/26/2016 8 p.m. EDT",15655,15770,13409,-2246
ISNE,"10/26/2016 9 p.m. EDT",15150,15190,12900,-2250
ISNE,"10/26/2016 10 p.m. EDT",14207,14200,11552,-2655
ISNE,"10/26/2016 11 p.m. EDT",12900,12910,10213,-2687
ISNE,"10/27/2016 12 a.m. EDT",11746,11750,9034,-2712
ISNE,"10/27/2016 1 a.m. EDT",11105,10940,8374,-2731
ISNE,"10/27/2016 2 a.m. EDT",11158,10530,8325,-2833
ISNE,"10/27/2016 3 a.m. EDT",11259,10340,8341,-2918
ISNE,"10/27/2016 4 a.m. EDT",11258,10320,8323,-2935
ISNE,"10/27/2016 5 a.m. EDT",11595,10720,8745,-2850
ISNE,"10/27/2016 6 a.m. EDT",12424,11870,9705,-2719
ISNE,"10/27/2016 7 a.m. EDT",13791,13810,11344,-2447
ISNE,"10/27/2016 8 a.m. EDT",14886,14930,12493,-2393
ISNE,"10/27/2016 9 a.m. EDT",15001,14980,12586,-2415
ISNE,"10/27/2016 10 a.m. EDT",14959,14850,12616,-2343
ISNE,"10/27/2016 11 a.m. EDT",14926,14740,12869,-2057
ISNE,"10/27/2016 12 p.m. EDT",14953,14660,13005,-1948
ISNE,"10/27/2016 1 p.m. EDT",14942,14630,12876,-2066
ISNE,"10/27/2016 2 p.m. EDT",15009,14680,12839,-2170
ISNE,"10/27/2016 3 p.m. EDT",14990,14700,12795,-2195
ISNE,"10/27/2016 4 p.m. EDT",15079,14780,12936,-2143
ISNE,"10/27/2016 5 p.m. EDT",15404,15200,13246,-2158
ISNE,"10/27/2016 6 p.m. EDT",16019,15650,13876,-2143
ISNE,"10/27/2016 7 p.m. EDT",16315,16190,14223,-2092
ISNE,"10/27/2016 8 p.m. EDT",15949,16020,13969,-1980
ISNE,"10/27/2016 9 p.m. EDT",15323,15210,13271,-2052
ISNE,"10/27/2016 10 p.m. EDT",14287,14140,12070,-2217
ISNE,"10/27/2016 11 p.m. EDT",12908,12800,10503,-2405
ISNE,"10/28/2016 12 a.m. EDT",11683,11620,9220,-2463
ISNE,"10/28/2016 1 a.m. EDT",10888,10790,8683,-2205
ISNE,"10/28/2016 2 a.m. EDT",10709,10320,8526,-2183
ISNE,"10/28/2016 3 a.m. EDT",10465,10070,8232,-2233
ISNE,"10/28/2016 4 a.m. EDT",10393,9990,8213,-2180
ISNE,"10/28/2016 5 a.m. EDT",10781,10280,8657,-2124
ISNE,"10/28/2016 6 a.m. EDT",11648,11300,9631,-2017
ISNE,"10/28/2016 7 a.m. EDT",13382,13070,11452,-1930
ISNE,"10/28/2016 8 a.m. EDT",14572,14220,12580,-1992
ISNE,"10/28/2016 9 a.m. EDT",14754,14470,12747,-2007
ISNE,"10/28/2016 10 a.m. EDT",14616,14530,12485,-2131
ISNE,"10/28/2016 11 a.m. EDT",14511,14500,12600,-1911
ISNE,"10/28/2016 12 p.m. EDT",14427,14410,12350,-2077
ISNE,"10/28/2016 1 p.m. EDT",14297,14280,12354,-1943
ISNE,"10/28/2016 2 p.m. EDT",14262,14180,12379,-1883
ISNE,"10/28/2016 3 p.m. EDT",14172,14160,12397,-1775
ISNE,"10/28/2016 4 p.m. EDT",14169,14190,12465,-1704
ISNE,"10/28/2016 5 p.m. EDT",14445,14430,12657,-1788
ISNE,"10/28/2016 6 p.m. EDT",14928,14900,12831,-2097
ISNE,"10/28/2016 7 p.m. EDT",15346,15400,13305,-2041
ISNE,"10/28/2016 8 p.m. EDT",14967,15090,12858,-2109
ISNE,"10/28/2016 9 p.m. EDT",14408,14510,12401,-2007
ISNE,"10/28/2016 10 p.m. EDT",13643,13690,11766,-1877
ISNE,"10/28/2016 11 p.m. EDT",12606,12660,10549,-2057
ISNE,"10/29/2016 12 a.m. EDT",11566,11600,9458,-2108
ISNE,"10/29/2016 1 a.m. EDT",10734,10780,8672,-2062
ISNE,"10/29/2016 2 a.m. EDT",10481,10330,8525,-1956
ISNE,"10/29/2016 3 a.m. EDT",10402,10050,8444,-1958
ISNE,"10/29/2016 4 a.m. EDT",10149,9900,8305,-1844
ISNE,"10/29/2016 5 a.m. EDT",10363,10000,8467,-1896
ISNE,"10/29/2016 6 a.m. EDT",10893,10400,8943,-1950
ISNE,"10/29/2016 7 a.m. EDT",11656,11200,9723,-1933
ISNE,"10/29/2016 8 a.m. EDT",12244,12030,10270,-1974
ISNE,"10/29/2016 9 a.m. EDT",12814,12750,10758,-2056
ISNE,"10/29/2016 10 a.m. EDT",13312,13100,11463,-1849
ISNE,"10/29/2016 11 a.m. EDT",13690,13140,12041,-1649
ISNE,"10/29/2016 12 p.m. EDT",13519,13100,12039,-1480
ISNE,"10/29/2016 1 p.m. EDT",13009,12890,11280,-1729
ISNE,"10/29/2016 2 p.m. EDT",12804,12640,11032,-1772
ISNE,"10/29/2016 3 p.m. EDT",12794,12550,11005,-1789
ISNE,"10/29/2016 4 p.m. EDT",12871,12640,11287,-1584
ISNE,"10/29/2016 5 p.m. EDT",13086,12970,11509,-1577
ISNE,"10/29/2016 6 p.m. EDT",13682,13540,12105,-1577
ISNE,"10/29/2016 7 p.m. EDT",14110,14150,12619,-1491
ISNE,"10/29/2016 8 p.m. EDT",13710,13810,12138,-1572
ISNE,"10/29/2016 9 p.m. EDT",13184,13320,11516,-1668
ISNE,"10/29/2016 10 p.m. EDT",12533,12660,10740,-1793
ISNE,"10/29/2016 11 p.m. EDT",11697,11790,9725,-1972
ISNE,"10/30/2016 12 a.m. EDT",10978,10890,9026,-1952
ISNE,"10/30/2016 1 a.m. EDT",10638,10130,8378,-2260
ISNE,"10/30/2016 2 a.m. EDT",10439,9660,8122,-2317
ISNE,"10/30/2016 3 a.m. EDT",10294,9420,8052,-2242
ISNE,"10/30/2016 4 a.m. EDT",10295,9270,8053,-2242
ISNE,"10/30/2016 5 a.m. EDT",10303,9280,8077,-2226
ISNE,"10/30/2016 6 a.m. EDT",10512,9520,8270,-2242
ISNE,"10/30/2016 7 a.m. EDT",10707,9980,8585,-2122
ISNE,"10/30/2016 8 a.m. EDT",10824,10690,8905,-1919
ISNE,"10/30/2016 9 a.m. EDT",11304,11460,9481,-1823
ISNE,"10/30/2016 10 a.m. EDT",11746,12260,9919,-1827
ISNE,"10/30/2016 11 a.m. EDT",11963,12540,10203,-1760
ISNE,"10/30/2016 12 p.m. EDT",12019,12600,10136,-1883
ISNE,"10/30/2016 1 p.m. EDT",12084,12580,9948,-2136
ISNE,"10/30/2016 2 p.m. EDT",12145,12500,9763,-2382
ISNE,"10/30/2016 3 p.m. EDT",12275,12430,9826,-2449
ISNE,"10/30/2016 4 p.m. EDT",12632,12520,10082,-2550
ISNE,"10/30/2016 5 p.m. EDT",13173,12970,10635,-2538
ISNE,"10/30/2016 6 p.m. EDT",13978,13620,11428,-2550
ISNE,"10/30/2016 7 p.m. EDT",14362,14400,11970,-2392
ISNE,"10/30/2016 8 p.m. EDT",14022,14330,11458,-2564
ISNE,"10/30/2016 9 p.m. EDT",13410,13700,10819,-2591
ISNE,"10/30/2016 10 p.m. EDT",12486,12710,9973,-2513
ISNE,"10/30/2016 11 p.m. EDT",11418,11610,8859,-2559
ISNE,"10/31/2016 12 a.m. EDT",10484,10670,7846,-2638
ISNE,"10/31/2016 1 a.m. EDT",10280,9980,7698,-2582
ISNE,"10/31/2016 2 a.m. EDT",10285,9640,7612,-2673
ISNE,"10/31/2016 3 a.m. EDT",10362,9500,7665,-2697
ISNE,"10/31/2016 4 a.m. EDT",10374,9530,7764,-2610
ISNE,"10/31/2016 5 a.m. EDT",10486,9670,8062,-2424
ISNE,"10/31/2016 6 a.m. EDT",11432,10750,8988,-2444
ISNE,"10/31/2016 7 a.m. EDT",12806,12640,10591,-2215
ISNE,"10/31/2016 8 a.m. EDT",13952,13910,11802,-2150
ISNE,"10/31/2016 9 a.m. EDT",14039,14080,11660,-2379
ISNE,"10/31/2016 10 a.m. EDT",13837,13920,11473,-2364
ISNE,"10/31/2016 11 a.m. EDT",13742,13800,11219,-2523
ISNE,"10/31/2016 12 p.m. EDT",13571,13720,11076,-2495
ISNE,"10/31/2016 1 p.m. EDT",13409,13570,11158,-2251
ISNE,"10/31/2016 2 p.m. EDT",13333,13500,11011,-2322
ISNE,"10/31/2016 3 p.m. EDT",13223,13490,10988,-2235
ISNE,"10/31/2016 4 p.m. EDT",13345,13630,11159,-2186
ISNE,"10/31/2016 5 p.m. EDT",13788,14040,11279,-2509
ISNE,"10/31/2016 6 p.m. EDT",14442,14860,11840,-2602
ISNE,"10/31/2016 7 p.m. EDT",14890,15700,12310,-2580
ISNE,"10/31/2016 8 p.m. EDT",14603,15550,11979,-2624
ISNE,"10/31/2016 9 p.m. EDT",14325,14940,11702,-2623
ISNE,"10/31/2016 10 p.m. EDT",13621,13920,11303,-2318
ISNE,"10/31/2016 11 p.m. EDT",12425,12620,10066,-2359
ISNE,"11/1/2016 12 a.m. EDT",11365,11490,8683,-2682
