"BA Code","Timestamp (Hour Ending)","Demand (MWh)","Demand Forecast (MWh)","Net Generation (MWh)","Total Interchange (MWh)"
ISNE,"6/1/2018 12 a.m. EDT",15119,11980,14844,-275
ISNE,"6/1/2018 1 a.m. EDT",14102,11430,11613,-2489
ISNE,"6/1/2018 2 a.m. EDT",11718,10910,9321,-2397
ISNE,"6/1/2018 3 a.m. EDT",11294,10580,9037,-2257
ISNE,"6/1/2018 4 a.m. EDT",10984,10440,8669,-2315
ISNE,"6/1/2018 5 a.m. EDT",11207,10770,8954,-2253
ISNE,"6/1/2018 6 a.m. EDT",11898,11370,9406,-2492
ISNE,"6/1/2018 7 a.m. EDT",13052,13050,10712,-2340
ISNE,"6/1/2018 8 a.m. EDT",14104,14290,12325,-1779
ISNE,"6/1/2018 9 a.m. EDT",14727,14900,13189,-1538
ISNE,"6/1/2018 10 a.m. EDT",15209,15200,14016,-1193
ISNE,"6/1/2018 11 a.m. EDT",15589,15590,14492,-1097
ISNE,"6/1/2018 12 p.m. EDT",15910,16030,14688,-1222
ISNE,"6/1/2018 1 p.m. EDT",16088,16270,14870,-1218
ISNE,"6/1/2018 2 p.m. EDT",16261,16480,14917,-1344
ISNE,"6/1/2018 3 p.m. EDT",16390,16750,15306,-1084
ISNE,"6/1/2018 4 p.m. EDT",16490,16870,15756,-734
ISNE,"6/1/2018 5 p.m. EDT",16759,17270,15773,-986
ISNE,"6/1/2018 6 p.m. EDT",17011,17290,15878,-1133
ISNE,"6/1/2018 7 p.m. EDT",16980,17060,15518,-1462
ISNE,"6/1/2018 8 p.m. EDT",16780,16970,15224,-1556
ISNE,"6/1/2018 9 p.m. EDT",16762,16750,15349,-1413
ISNE,"6/1/2018 10 p.m. EDT",16187,16280,14627,-1560
ISNE,"6/1/2018 11 p.m. EDT",14913,14970,13008,-1905
ISNE,"6/2/2018 12 a.m. EDT",13533,13480,11291,-2242
ISNE,"6/2/2018 1 a.m. EDT",12461,12480,10746,-1715
ISNE,"6/2/2018 2 a.m. EDT",11768,11930,9852,-1916
ISNE,"6/2/2018 3 a.m. EDT",11612,11490,9507,-2105
ISNE,"6/2/2018 4 a.m. EDT",11382,11290,9186,-2196
ISNE,"6/2/2018 5 a.m. EDT",11336,11050,9137,-2199
ISNE,"6/2/2018 6 a.m. EDT",11730,11660,9190,-2540
ISNE,"6/2/2018 7 a.m. EDT",12333,12330,9458,-2875
ISNE,"6/2/2018 8 a.m. EDT",13179,13140,10409,-2770
ISNE,"6/2/2018 9 a.m. EDT",13847,13880,11533,-2314
ISNE,"6/2/2018 10 a.m. EDT",14744,14650,12355,-2389
ISNE,"6/2/2018 11 a.m. EDT",15539,15360,13197,-2342
ISNE,"6/2/2018 12 p.m. EDT",15906,15890,13311,-2595
ISNE,"6/2/2018 1 p.m. EDT",15963,16000,13661,-2302
ISNE,"6/2/2018 2 p.m. EDT",16051,16120,14102,-1949
ISNE,"6/2/2018 3 p.m. EDT",16112,16200,14494,-1618
ISNE,"6/2/2018 4 p.m. EDT",16275,16390,14423,-1852
ISNE,"6/2/2018 5 p.m. EDT",16454,16510,14333,-2121
ISNE,"6/2/2018 6 p.m. EDT",16508,16640,14328,-2180
ISNE,"6/2/2018 7 p.m. EDT",16412,16140,14436,-1976
ISNE,"6/2/2018 8 p.m. EDT",15943,15760,13983,-1960
ISNE,"6/2/2018 9 p.m. EDT",15577,15650,13543,-2034
ISNE,"6/2/2018 10 p.m. EDT",14935,14980,13014,-1921
ISNE,"6/2/2018 11 p.m. EDT",13745,13740,11718,-2027
ISNE,"6/3/2018 12 a.m. EDT",12656,12370,10358,-2298
ISNE,"6/3/2018 1 a.m. EDT",11818,11100,9442,-2376
ISNE,"6/3/2018 2 a.m. EDT",11058,10630,8734,-2324
ISNE,"6/3/2018 3 a.m. EDT",10575,10050,8291,-2284
ISNE,"6/3/2018 4 a.m. EDT",10270,9550,7923,-2347
ISNE,"6/3/2018 5 a.m. EDT",10190,9600,7552,-2638
ISNE,"6/3/2018 6 a.m. EDT",10225,9640,7430,-2795
ISNE,"6/3/2018 7 a.m. EDT",10491,9930,7614,-2877
ISNE,"6/3/2018 8 a.m. EDT",10908,10470,7863,-3045
ISNE,"6/3/2018 9 a.m. EDT",11589,11130,8497,-3092
ISNE,"6/3/2018 10 a.m. EDT",11401,10930,8802,-2599
ISNE,"6/3/2018 11 a.m. EDT",11244,10960,9130,-2114
ISNE,"6/3/2018 12 p.m. EDT",11177,11320,9157,-2020
ISNE,"6/3/2018 1 p.m. EDT",11102,11230,9164,-1938
ISNE,"6/3/2018 2 p.m. EDT",11052,11330,8975,-2077
ISNE,"6/3/2018 3 p.m. EDT",11131,11450,9093,-2038
ISNE,"6/3/2018 4 p.m. EDT",11396,11540,9384,-2012
ISNE,"6/3/2018 5 p.m. EDT",11770,12350,9697,-2073
ISNE,"6/3/2018 6 p.m. EDT",12517,12910,10420,-2097
ISNE,"6/3/2018 7 p.m. EDT",12905,12970,10866,-2039
ISNE,"6/3/2018 8 p.m. EDT",12953,13030,10764,-2189
ISNE,"6/3/2018 9 p.m. EDT",13056,13130,10705,-2351
ISNE,"6/3/2018 10 p.m. EDT",12551,12570,10121,-2430
ISNE,"6/3/2018 11 p.m. EDT",11418,11530,8890,-2528
ISNE,"6/4/2018 12 a.m. EDT",10830,10540,8374,-2456
ISNE,"6/4/2018 1 a.m. EDT",9901,9580,7831,-2070
ISNE,"6/4/2018 2 a.m. EDT",9733,9200,7726,-2007
ISNE,"6/4/2018 3 a.m. EDT",9550,9020,7636,-1914
ISNE,"6/4/2018 4 a.m. EDT",9521,9000,7331,-2190
ISNE,"6/4/2018 5 a.m. EDT",9810,9260,7611,-2199
ISNE,"6/4/2018 6 a.m. EDT",10610,10190,8222,-2388
ISNE,"6/4/2018 7 a.m. EDT",11834,11800,9462,-2372
ISNE,"6/4/2018 8 a.m. EDT",12776,12920,10704,-2072
ISNE,"6/4/2018 9 a.m. EDT",13319,13420,11369,-1950
ISNE,"6/4/2018 10 a.m. EDT",13616,13600,11542,-2074
ISNE,"6/4/2018 11 a.m. EDT",13814,13820,11607,-2207
ISNE,"6/4/2018 12 p.m. EDT",13761,13850,11589,-2172
ISNE,"6/4/2018 1 p.m. EDT",13591,13860,11316,-2275
ISNE,"6/4/2018 2 p.m. EDT",13606,13900,11262,-2344
ISNE,"6/4/2018 3 p.m. EDT",13556,13920,11324,-2232
ISNE,"6/4/2018 4 p.m. EDT",13489,13850,11346,-2143
ISNE,"6/4/2018 5 p.m. EDT",13581,14010,11525,-2056
ISNE,"6/4/2018 6 p.m. EDT",13895,14310,12070,-1825
ISNE,"6/4/2018 7 p.m. EDT",13968,14290,11980,-1988
ISNE,"6/4/2018 8 p.m. EDT",13859,14220,11690,-2169
ISNE,"6/4/2018 9 p.m. EDT",13751,13930,11593,-2158
ISNE,"6/4/2018 10 p.m. EDT",13012,13150,11031,-1981
ISNE,"6/4/2018 11 p.m. EDT",11752,11870,9403,-2349
ISNE,"6/5/2018 12 a.m. EDT",10608,10700,7968,-2640
ISNE,"6/5/2018 1 a.m. EDT",9850,9840,7053,-2797
ISNE,"6/5/2018 2 a.m. EDT",9642,9410,7171,-2471
ISNE,"6/5/2018 3 a.m. EDT",9704,9210,7487,-2217
ISNE,"6/5/2018 4 a.m. EDT",9963,9180,7802,-2161
ISNE,"6/5/2018 5 a.m. EDT",9966,9470,7806,-2160
ISNE,"6/5/2018 6 a.m. EDT",10439,10220,8512,-1927
ISNE,"6/5/2018 7 a.m. EDT",12048,11670,10188,-1860
ISNE,"6/5/2018 8 a.m. EDT",13091,12600,11029,-2062
ISNE,"6/5/2018 9 a.m. EDT",12650,12640,11024,-1626
ISNE,"6/5/2018 10 a.m. EDT",12583,12520,10896,-1687
ISNE,"6/5/2018 11 a.m. EDT",12937,12640,11518,-1419
ISNE,"6/5/2018 12 p.m. EDT",13409,12730,11578,-1831
ISNE,"6/5/2018 1 p.m. EDT",13589,13080,11395,-2194
ISNE,"6/5/2018 2 p.m. EDT",13693,13070,11591,-2102
ISNE,"6/5/2018 3 p.m. EDT",13470,13230,11183,-2287
ISNE,"6/5/2018 4 p.m. EDT",13406,13380,10965,-2441
ISNE,"6/5/2018 5 p.m. EDT",13412,13630,11020,-2392
ISNE,"6/5/2018 6 p.m. EDT",13851,13820,11917,-1934
ISNE,"6/5/2018 7 p.m. EDT",13973,13880,11827,-2146
ISNE,"6/5/2018 8 p.m. EDT",13912,14000,11652,-2260
ISNE,"6/5/2018 9 p.m. EDT",13800,13840,11583,-2217
ISNE,"6/5/2018 10 p.m. EDT",13102,13190,10913,-2189
ISNE,"6/5/2018 11 p.m. EDT",11843,11880,9477,-2366
ISNE,"6/6/2018 12 a.m. EDT",10686,10670,8149,-2537
ISNE,"6/6/2018 1 a.m. EDT",10352,9890,8102,-2250
ISNE,"6/6/2018 2 a.m. EDT",9987,9450,8092,-1895
ISNE,"6/6/2018 3 a.m. EDT",9745,9220,7676,-2069
ISNE,"6/6/2018 4 a.m. EDT",9695,9180,7706,-1989
ISNE,"6/6/2018 5 a.m. EDT",9946,9450,7749,-2197
ISNE,"6/6/2018 6 a.m. EDT",10458,10250,8338,-2120
ISNE,"6/6/2018 7 a.m. EDT",11622,11830,9902,-1720
ISNE,"6/6/2018 8 a.m. EDT",12625,12850,10912,-1713
ISNE,"6/6/2018 9 a.m. EDT",12878,13050,11144,-1734
ISNE,"6/6/2018 10 a.m. EDT",12928,13020,11149,-1779
ISNE,"6/6/2018 11 a.m. EDT",12981,13040,10758,-2223
ISNE,"6/6/2018 12 p.m. EDT",12986,13020,10896,-2090
ISNE,"6/6/2018 1 p.m. EDT",12912,13030,11165,-1747
ISNE,"6/6/2018 2 p.m. EDT",12980,13110,11292,-1688
ISNE,"6/6/2018 3 p.m. EDT",12955,13210,11239,-1716
ISNE,"6/6/2018 4 p.m. EDT",13028,13330,11495,-1533
ISNE,"6/6/2018 5 p.m. EDT",13273,13580,11783,-1490
ISNE,"6/6/2018 6 p.m. EDT",13598,13790,11696,-1902
ISNE,"6/6/2018 7 p.m. EDT",13729,13830,11837,-1892
ISNE,"6/6/2018 8 p.m. EDT",13751,13900,11619,-2132
ISNE,"6/6/2018 9 p.m. EDT",13847,13890,11577,-2270
ISNE,"6/6/2018 10 p.m. EDT",13281,13320,11347,-1934
ISNE,"6/6/2018 11 p.m. EDT",12016,12020,9745,-2271
ISNE,"6/7/2018 12 a.m. EDT",10815,10790,8395,-2420
ISNE,"6/7/2018 1 a.m. EDT",10299,10000,7702,-2597
ISNE,"6/7/2018 2 a.m. EDT",9819,9530,7399,-2420
ISNE,"6/7/2018 3 a.m. EDT",9773,9300,7288,-2485
ISNE,"6/7/2018 4 a.m. EDT",10024,9240,7522,-2502
ISNE,"6/7/2018 5 a.m. EDT",10252,9480,7617,-2635
ISNE,"6/7/2018 6 a.m. EDT",10235,10200,8004,-2231
ISNE,"6/7/2018 7 a.m. EDT",11548,11590,9576,-1972
ISNE,"6/7/2018 8 a.m. EDT",12559,12570,10846,-1713
ISNE,"6/7/2018 9 a.m. EDT",12789,12810,10986,-1803
ISNE,"6/7/2018 10 a.m. EDT",12915,12890,10800,-2115
ISNE,"6/7/2018 11 a.m. EDT",12949,13010,10945,-2004
ISNE,"6/7/2018 12 p.m. EDT",13052,13190,11039,-2013
ISNE,"6/7/2018 1 p.m. EDT",13153,13320,11260,-1893
ISNE,"6/7/2018 2 p.m. EDT",13378,13390,11492,-1886
ISNE,"6/7/2018 3 p.m. EDT",13461,13530,11677,-1784
ISNE,"6/7/2018 4 p.m. EDT",13478,13620,11577,-1901
ISNE,"6/7/2018 5 p.m. EDT",13613,13870,11978,-1635
ISNE,"6/7/2018 6 p.m. EDT",13871,14100,12329,-1542
ISNE,"6/7/2018 7 p.m. EDT",13910,14070,11985,-1925
ISNE,"6/7/2018 8 p.m. EDT",13858,14150,11563,-2295
ISNE,"6/7/2018 9 p.m. EDT",13955,14020,11606,-2349
ISNE,"6/7/2018 10 p.m. EDT",13449,13440,11323,-2126
ISNE,"6/7/2018 11 p.m. EDT",12203,12170,9593,-2610
ISNE,"6/8/2018 12 a.m. EDT",11009,10930,8308,-2701
ISNE,"6/8/2018 1 a.m. EDT",10151,10130,7717,-2434
ISNE,"6/8/2018 2 a.m. EDT",9933,9660,7713,-2220
ISNE,"6/8/2018 3 a.m. EDT",10182,9410,8020,-2162
ISNE,"6/8/2018 4 a.m. EDT",10127,9320,7817,-2310
ISNE,"6/8/2018 5 a.m. EDT",10346,9550,7801,-2545
ISNE,"6/8/2018 6 a.m. EDT",10417,10200,8056,-2361
ISNE,"6/8/2018 7 a.m. EDT",11520,11550,8989,-2531
ISNE,"6/8/2018 8 a.m. EDT",12515,12530,10240,-2275
ISNE,"6/8/2018 9 a.m. EDT",12813,12820,10874,-1939
ISNE,"6/8/2018 10 a.m. EDT",13003,13050,10986,-2017
ISNE,"6/8/2018 11 a.m. EDT",13265,13340,11449,-1816
ISNE,"6/8/2018 12 p.m. EDT",13546,13650,11496,-2050
ISNE,"6/8/2018 1 p.m. EDT",13839,13980,12070,-1769
ISNE,"6/8/2018 2 p.m. EDT",14330,14270,12634,-1696
ISNE,"6/8/2018 3 p.m. EDT",14639,14710,12981,-1658
ISNE,"6/8/2018 4 p.m. EDT",14776,14970,13024,-1752
ISNE,"6/8/2018 5 p.m. EDT",15022,15220,13426,-1596
ISNE,"6/8/2018 6 p.m. EDT",15262,15290,13409,-1853
ISNE,"6/8/2018 7 p.m. EDT",15174,15140,13163,-2011
ISNE,"6/8/2018 8 p.m. EDT",14908,14940,12846,-2062
ISNE,"6/8/2018 9 p.m. EDT",14781,14870,12650,-2131
ISNE,"6/8/2018 10 p.m. EDT",14353,14330,12302,-2051
ISNE,"6/8/2018 11 p.m. EDT",13207,13060,10716,-2491
ISNE,"6/9/2018 12 a.m. EDT",11941,11650,9349,-2592
ISNE,"6/9/2018 1 a.m. EDT",10974,10950,8563,-2411
ISNE,"6/9/2018 2 a.m. EDT",10321,10300,8140,-2181
ISNE,"6/9/2018 3 a.m. EDT",10141,9880,7995,-2146
ISNE,"6/9/2018 4 a.m. EDT",9926,9650,7821,-2105
ISNE,"6/9/2018 5 a.m. EDT",9867,9600,7600,-2267
ISNE,"6/9/2018 6 a.m. EDT",9908,9650,8045,-1863
ISNE,"6/9/2018 7 a.m. EDT",10419,10180,8334,-2085
ISNE,"6/9/2018 8 a.m. EDT",10866,10890,8955,-1911
ISNE,"6/9/2018 9 a.m. EDT",11507,11520,9521,-1986
ISNE,"6/9/2018 10 a.m. EDT",11908,11940,9830,-2078
ISNE,"6/9/2018 11 a.m. EDT",12195,12120,9994,-2201
ISNE,"6/9/2018 12 p.m. EDT",12492,12280,10406,-2086
ISNE,"6/9/2018 1 p.m. EDT",12712,12490,10729,-1983
ISNE,"6/9/2018 2 p.m. EDT",12877,12630,10974,-1903
ISNE,"6/9/2018 3 p.m. EDT",12973,12950,10944,-2029
ISNE,"6/9/2018 4 p.m. EDT",13198,13220,11445,-1753
ISNE,"6/9/2018 5 p.m. EDT",13600,13630,11743,-1857
ISNE,"6/9/2018 6 p.m. EDT",13994,13880,12040,-1954
ISNE,"6/9/2018 7 p.m. EDT",14075,14020,12103,-1972
ISNE,"6/9/2018 8 p.m. EDT",13960,13860,11760,-2200
ISNE,"6/9/2018 9 p.m. EDT",13880,13870,11646,-2234
ISNE,"6/9/2018 10 p.m. EDT",13534,13590,11720,-1814
ISNE,"6/9/2018 11 p.m. EDT",12573,12670,10210,-2363
ISNE,"6/10/2018 12 a.m. EDT",11474,11510,8938,-2536
ISNE,"6/10/2018 1 a.m. EDT",10836,10550,8894,-1942
ISNE,"6/10/2018 2 a.m. EDT",10222,9950,8582,-1640
ISNE,"6/10/2018 3 a.m. EDT",10093,9580,8251,-1842
ISNE,"6/10/2018 4 a.m. EDT",10156,9350,8265,-1891
ISNE,"6/10/2018 5 a.m. EDT",10054,9260,8044,-2010
ISNE,"6/10/2018 6 a.m. EDT",9968,9170,7837,-2131
ISNE,"6/10/2018 7 a.m. EDT",10205,9430,7945,-2260
ISNE,"6/10/2018 8 a.m. EDT",10805,9950,8457,-2348
ISNE,"6/10/2018 9 a.m. EDT",11160,10580,8957,-2203
ISNE,"6/10/2018 10 a.m. EDT",11309,11050,9421,-1888
ISNE,"6/10/2018 11 a.m. EDT",11437,11280,9708,-1729
ISNE,"6/10/2018 12 p.m. EDT",11666,11510,10154,-1512
ISNE,"6/10/2018 1 p.m. EDT",11814,11670,10505,-1309
ISNE,"6/10/2018 2 p.m. EDT",11751,11880,10000,-1751
ISNE,"6/10/2018 3 p.m. EDT",11791,12060,9938,-1853
ISNE,"6/10/2018 4 p.m. EDT",12053,12190,10472,-1581
ISNE,"6/10/2018 5 p.m. EDT",12493,12650,10888,-1605
ISNE,"6/10/2018 6 p.m. EDT",13031,13080,10951,-2080
ISNE,"6/10/2018 7 p.m. EDT",13294,13500,10973,-2321
ISNE,"6/10/2018 8 p.m. EDT",13375,13430,10952,-2423
ISNE,"6/10/2018 9 p.m. EDT",13481,13410,11017,-2464
ISNE,"6/10/2018 10 p.m. EDT",13050,12810,10718,-2332
ISNE,"6/10/2018 11 p.m. EDT",11868,11740,9360,-2508
ISNE,"6/11/2018 12 a.m. EDT",10728,10610,8298,-2430
ISNE,"6/11/2018 1 a.m. EDT",10230,9930,7989,-2241
ISNE,"6/11/2018 2 a.m. EDT",9942,9480,7597,-2345
ISNE,"6/11/2018 3 a.m. EDT",9976,9260,7689,-2287
ISNE,"6/11/2018 4 a.m. EDT",9988,9210,7992,-1996
ISNE,"6/11/2018 5 a.m. EDT",10260,9490,7882,-2378
ISNE,"6/11/2018 6 a.m. EDT",10598,10240,8216,-2382
ISNE,"6/11/2018 7 a.m. EDT",11601,11640,8994,-2607
ISNE,"6/11/2018 8 a.m. EDT",12625,12640,10385,-2240
ISNE,"6/11/2018 9 a.m. EDT",12877,12860,10724,-2153
ISNE,"6/11/2018 10 a.m. EDT",12881,12850,10778,-2103
ISNE,"6/11/2018 11 a.m. EDT",12989,13050,10829,-2160
ISNE,"6/11/2018 12 p.m. EDT",12978,13200,10958,-2020
ISNE,"6/11/2018 1 p.m. EDT",12925,13230,10931,-1994
ISNE,"6/11/2018 2 p.m. EDT",13140,13460,10955,-2185
ISNE,"6/11/2018 3 p.m. EDT",13338,13430,11187,-2151
ISNE,"6/11/2018 4 p.m. EDT",13519,13630,11561,-1958
ISNE,"6/11/2018 5 p.m. EDT",13827,14060,11741,-2086
ISNE,"6/11/2018 6 p.m. EDT",14233,14190,12047,-2186
ISNE,"6/11/2018 7 p.m. EDT",14433,14310,11925,-2508
ISNE,"6/11/2018 8 p.m. EDT",14297,14240,11513,-2784
ISNE,"6/11/2018 9 p.m. EDT",14106,14210,11348,-2758
ISNE,"6/11/2018 10 p.m. EDT",13527,13420,10785,-2742
ISNE,"6/11/2018 11 p.m. EDT",12184,12060,9084,-3100
ISNE,"6/12/2018 12 a.m. EDT",10881,10850,7937,-2944
ISNE,"6/12/2018 1 a.m. EDT",10200,10010,7470,-2730
ISNE,"6/12/2018 2 a.m. EDT",9800,9540,7177,-2623
ISNE,"6/12/2018 3 a.m. EDT",10008,9300,7234,-2774
ISNE,"6/12/2018 4 a.m. EDT",10022,9230,7052,-2970
ISNE,"6/12/2018 5 a.m. EDT",10237,9480,7228,-3009
ISNE,"6/12/2018 6 a.m. EDT",10472,10160,7744,-2728
ISNE,"6/12/2018 7 a.m. EDT",11502,11530,8750,-2752
ISNE,"6/12/2018 8 a.m. EDT",12462,12460,9493,-2969
ISNE,"6/12/2018 9 a.m. EDT",12458,12460,9525,-2933
ISNE,"6/12/2018 10 a.m. EDT",12688,12670,9942,-2746
ISNE,"6/12/2018 11 a.m. EDT",12830,12800,10054,-2776
ISNE,"6/12/2018 12 p.m. EDT",13003,13040,10314,-2689
ISNE,"6/12/2018 1 p.m. EDT",13121,13090,10652,-2469
ISNE,"6/12/2018 2 p.m. EDT",13424,13450,10877,-2547
ISNE,"6/12/2018 3 p.m. EDT",13636,13650,10866,-2770
ISNE,"6/12/2018 4 p.m. EDT",13991,13860,11044,-2947
ISNE,"6/12/2018 5 p.m. EDT",14486,14330,11691,-2795
ISNE,"6/12/2018 6 p.m. EDT",14990,14600,12243,-2747
ISNE,"6/12/2018 7 p.m. EDT",15098,14620,12265,-2833
ISNE,"6/12/2018 8 p.m. EDT",14814,14520,11891,-2923
ISNE,"6/12/2018 9 p.m. EDT",14671,14460,11629,-3042
ISNE,"6/12/2018 10 p.m. EDT",14060,13790,11079,-2981
ISNE,"6/12/2018 11 p.m. EDT",12681,12390,9227,-3454
ISNE,"6/13/2018 12 a.m. EDT",11326,11110,8619,-2707
ISNE,"6/13/2018 1 a.m. EDT",11001,10490,8110,-2891
ISNE,"6/13/2018 2 a.m. EDT",10636,9960,7855,-2781
ISNE,"6/13/2018 3 a.m. EDT",10484,9700,7744,-2740
ISNE,"6/13/2018 4 a.m. EDT",10368,9580,7689,-2679
ISNE,"6/13/2018 5 a.m. EDT",10587,9820,7725,-2862
ISNE,"6/13/2018 6 a.m. EDT",10921,10480,8195,-2726
ISNE,"6/13/2018 7 a.m. EDT",11896,11930,9285,-2611
ISNE,"6/13/2018 8 a.m. EDT",12997,13000,10834,-2163
ISNE,"6/13/2018 9 a.m. EDT",13515,13520,11623,-1892
ISNE,"6/13/2018 10 a.m. EDT",13988,13950,11710,-2278
ISNE,"6/13/2018 11 a.m. EDT",14533,14120,12173,-2360
ISNE,"6/13/2018 12 p.m. EDT",14883,14700,12593,-2290
ISNE,"6/13/2018 1 p.m. EDT",14978,14890,12259,-2719
ISNE,"6/13/2018 2 p.m. EDT",15324,15340,12547,-2777
ISNE,"6/13/2018 3 p.m. EDT",15391,15360,12888,-2503
ISNE,"6/13/2018 4 p.m. EDT",15405,15550,12676,-2729
ISNE,"6/13/2018 5 p.m. EDT",15407,15800,12948,-2459
ISNE,"6/13/2018 6 p.m. EDT",15512,15880,12971,-2541
ISNE,"6/13/2018 7 p.m. EDT",15426,15690,13012,-2414
ISNE,"6/13/2018 8 p.m. EDT",15394,15680,13014,-2380
ISNE,"6/13/2018 9 p.m. EDT",15367,15660,12797,-2570
ISNE,"6/13/2018 10 p.m. EDT",14816,15040,12514,-2302
ISNE,"6/13/2018 11 p.m. EDT",13536,13580,11008,-2528
ISNE,"6/14/2018 12 a.m. EDT",12269,12260,9843,-2426
ISNE,"6/14/2018 1 a.m. EDT",11669,11530,9423,-2246
ISNE,"6/14/2018 2 a.m. EDT",11516,11050,9305,-2211
ISNE,"6/14/2018 3 a.m. EDT",11756,10570,9469,-2287
ISNE,"6/14/2018 4 a.m. EDT",11617,10540,9188,-2429
ISNE,"6/14/2018 5 a.m. EDT",11721,10620,8979,-2742
ISNE,"6/14/2018 6 a.m. EDT",11906,11140,9285,-2621
ISNE,"6/14/2018 7 a.m. EDT",12714,12700,10091,-2623
ISNE,"6/14/2018 8 a.m. EDT",13760,13740,11314,-2446
ISNE,"6/14/2018 9 a.m. EDT",14063,14110,11426,-2637
ISNE,"6/14/2018 10 a.m. EDT",14240,14170,11455,-2785
ISNE,"6/14/2018 11 a.m. EDT",14531,14390,11692,-2839
ISNE,"6/14/2018 12 p.m. EDT",14825,14750,11950,-2875
ISNE,"6/14/2018 1 p.m. EDT",15185,14970,12679,-2506
ISNE,"6/14/2018 2 p.m. EDT",15519,15280,12855,-2664
ISNE,"6/14/2018 3 p.m. EDT",15619,15460,12834,-2785
ISNE,"6/14/2018 4 p.m. EDT",15693,15670,12986,-2707
ISNE,"6/14/2018 5 p.m. EDT",15768,16030,13392,-2376
ISNE,"6/14/2018 6 p.m. EDT",15703,16280,13424,-2279
ISNE,"6/14/2018 7 p.m. EDT",15416,15990,12843,-2573
ISNE,"6/14/2018 8 p.m. EDT",15156,15680,12679,-2477
ISNE,"6/14/2018 9 p.m. EDT",15005,15510,13003,-2002
ISNE,"6/14/2018 10 p.m. EDT",14465,14740,12591,-1874
ISNE,"6/14/2018 11 p.m. EDT",13172,13250,10991,-2181
ISNE,"6/15/2018 12 a.m. EDT",12085,11870,9759,-2326
ISNE,"6/15/2018 1 a.m. EDT",11065,10960,8663,-2402
ISNE,"6/15/2018 2 a.m. EDT",10848,10350,8378,-2470
ISNE,"6/15/2018 3 a.m. EDT",10704,9970,8206,-2498
ISNE,"6/15/2018 4 a.m. EDT",10648,9910,7991,-2657
ISNE,"6/15/2018 5 a.m. EDT",10731,10070,8067,-2664
ISNE,"6/15/2018 6 a.m. EDT",11172,10710,8696,-2476
ISNE,"6/15/2018 7 a.m. EDT",12098,12090,9961,-2137
ISNE,"6/15/2018 8 a.m. EDT",13178,13140,11164,-2014
ISNE,"6/15/2018 9 a.m. EDT",13620,13610,11388,-2232
ISNE,"6/15/2018 10 a.m. EDT",13762,13720,11240,-2522
ISNE,"6/15/2018 11 a.m. EDT",13896,13680,11546,-2350
ISNE,"6/15/2018 12 p.m. EDT",13912,13590,11682,-2230
ISNE,"6/15/2018 1 p.m. EDT",13788,13710,11522,-2266
ISNE,"6/15/2018 2 p.m. EDT",13622,13940,11358,-2264
ISNE,"6/15/2018 3 p.m. EDT",13484,13830,11442,-2042
ISNE,"6/15/2018 4 p.m. EDT",13541,14240,11727,-1814
ISNE,"6/15/2018 5 p.m. EDT",13637,14100,12083,-1554
ISNE,"6/15/2018 6 p.m. EDT",13817,14400,12225,-1592
ISNE,"6/15/2018 7 p.m. EDT",13931,14100,11977,-1954
ISNE,"6/15/2018 8 p.m. EDT",13870,13890,11633,-2237
ISNE,"6/15/2018 9 p.m. EDT",13707,13910,11277,-2430
ISNE,"6/15/2018 10 p.m. EDT",13398,13580,11106,-2292
ISNE,"6/15/2018 11 p.m. EDT",12400,12480,9872,-2528
ISNE,"6/16/2018 12 a.m. EDT",11265,11320,8450,-2815
ISNE,"6/16/2018 1 a.m. EDT",10600,10390,7598,-3002
ISNE,"6/16/2018 2 a.m. EDT",10403,9850,7512,-2891
ISNE,"6/16/2018 3 a.m. EDT",10597,9530,7784,-2813
ISNE,"6/16/2018 4 a.m. EDT",10437,9340,7679,-2758
ISNE,"6/16/2018 5 a.m. EDT",10430,9410,7494,-2936
ISNE,"6/16/2018 6 a.m. EDT",10222,9490,7597,-2625
ISNE,"6/16/2018 7 a.m. EDT",10728,9850,8106,-2622
ISNE,"6/16/2018 8 a.m. EDT",11071,10660,8985,-2086
ISNE,"6/16/2018 9 a.m. EDT",11433,11480,9335,-2098
ISNE,"6/16/2018 10 a.m. EDT",11826,11890,9512,-2314
ISNE,"6/16/2018 11 a.m. EDT",12145,12270,10006,-2139
ISNE,"6/16/2018 12 p.m. EDT",12338,12350,10496,-1842
ISNE,"6/16/2018 1 p.m. EDT",12531,12740,10910,-1621
ISNE,"6/16/2018 2 p.m. EDT",12848,13010,11261,-1587
ISNE,"6/16/2018 3 p.m. EDT",13252,13560,12046,-1206
ISNE,"6/16/2018 4 p.m. EDT",13815,14150,12920,-895
ISNE,"6/16/2018 5 p.m. EDT",14419,14600,13189,-1230
ISNE,"6/16/2018 6 p.m. EDT",14818,15190,13224,-1594
ISNE,"6/16/2018 7 p.m. EDT",15003,15650,13085,-1918
ISNE,"6/16/2018 8 p.m. EDT",14908,15060,12643,-2265
ISNE,"6/16/2018 9 p.m. EDT",14656,14940,12576,-2080
ISNE,"6/16/2018 10 p.m. EDT",14297,14690,12277,-2020
ISNE,"6/16/2018 11 p.m. EDT",13234,13810,10921,-2313
ISNE,"6/17/2018 12 a.m. EDT",12248,12410,9804,-2444
ISNE,"6/17/2018 1 a.m. EDT",11166,11020,8221,-2945
ISNE,"6/17/2018 2 a.m. EDT",10627,10380,7567,-3060
ISNE,"6/17/2018 3 a.m. EDT",10496,9970,7544,-2952
ISNE,"6/17/2018 4 a.m. EDT",10278,9740,7279,-2999
ISNE,"6/17/2018 5 a.m. EDT",10185,9560,7152,-3033
ISNE,"6/17/2018 6 a.m. EDT",10331,9620,7350,-2981
ISNE,"6/17/2018 7 a.m. EDT",10591,10290,7501,-3090
ISNE,"6/17/2018 8 a.m. EDT",10796,10670,8168,-2628
ISNE,"6/17/2018 9 a.m. EDT",11253,11580,9387,-1866
ISNE,"6/17/2018 10 a.m. EDT",11925,12170,10342,-1583
ISNE,"6/17/2018 11 a.m. EDT",12676,12670,11049,-1627
ISNE,"6/17/2018 12 p.m. EDT",13273,13410,11649,-1624
ISNE,"6/17/2018 1 p.m. EDT",13740,13780,11914,-1826
ISNE,"6/17/2018 2 p.m. EDT",14139,14560,12217,-1922
ISNE,"6/17/2018 3 p.m. EDT",14588,15170,12425,-2163
ISNE,"6/17/2018 4 p.m. EDT",15198,16070,13216,-1982
ISNE,"6/17/2018 5 p.m. EDT",15923,16590,13822,-2101
ISNE,"6/17/2018 6 p.m. EDT",16431,16660,14402,-2029
ISNE,"6/17/2018 7 p.m. EDT",16577,16900,14278,-2299
ISNE,"6/17/2018 8 p.m. EDT",16334,16640,13798,-2536
ISNE,"6/17/2018 9 p.m. EDT",16151,16630,13726,-2425
ISNE,"6/17/2018 10 p.m. EDT",15699,15950,13403,-2296
ISNE,"6/17/2018 11 p.m. EDT",14331,14690,11730,-2601
ISNE,"6/18/2018 12 a.m. EDT",12996,12980,10090,-2906
ISNE,"6/18/2018 1 a.m. EDT",12040,11680,9034,-3006
ISNE,"6/18/2018 2 a.m. EDT",11561,11060,8855,-2706
ISNE,"6/18/2018 3 a.m. EDT",11299,10750,8656,-2643
ISNE,"6/18/2018 4 a.m. EDT",11376,10640,8691,-2685
ISNE,"6/18/2018 5 a.m. EDT",11517,10900,8949,-2568
ISNE,"6/18/2018 6 a.m. EDT",11729,11570,9331,-2398
ISNE,"6/18/2018 7 a.m. EDT",13107,13080,11168,-1939
ISNE,"6/18/2018 8 a.m. EDT",14462,14490,12215,-2247
ISNE,"6/18/2018 9 a.m. EDT",15257,15290,13025,-2232
ISNE,"6/18/2018 10 a.m. EDT",16073,16160,13779,-2294
ISNE,"6/18/2018 11 a.m. EDT",16997,17050,14777,-2220
ISNE,"6/18/2018 12 p.m. EDT",17933,17880,15645,-2288
ISNE,"6/18/2018 1 p.m. EDT",18658,18550,16669,-1989
ISNE,"6/18/2018 2 p.m. EDT",19449,19250,17882,-1567
ISNE,"6/18/2018 3 p.m. EDT",19993,19720,18328,-1665
ISNE,"6/18/2018 4 p.m. EDT",20337,20240,18677,-1660
ISNE,"6/18/2018 5 p.m. EDT",20685,20770,19081,-1604
ISNE,"6/18/2018 6 p.m. EDT",20822,21000,19077,-1745
ISNE,"6/18/2018 7 p.m. EDT",20233,20670,17646,-2587
ISNE,"6/18/2018 8 p.m. EDT",19513,20200,16708,-2805
ISNE,"6/18/2018 9 p.m. EDT",18848,19570,16497,-2351
ISNE,"6/18/2018 10 p.m. EDT",17807,18570,15701,-2106
ISNE,"6/18/2018 11 p.m. EDT",16156,16760,14171,-1985
ISNE,"6/19/2018 12 a.m. EDT",14634,15070,12713,-1921
ISNE,"6/19/2018 1 a.m. EDT",13755,13760,11284,-2471
ISNE,"6/19/2018 2 a.m. EDT",13730,13330,11198,-2532
ISNE,"6/19/2018 3 a.m. EDT",13756,12730,11206,-2550
ISNE,"6/19/2018 4 a.m. EDT",13649,12690,10968,-2681
ISNE,"6/19/2018 5 a.m. EDT",13810,12750,11032,-2778
ISNE,"6/19/2018 6 a.m. EDT",14229,13600,11488,-2741
ISNE,"6/19/2018 7 a.m. EDT",15018,14900,12359,-2659
ISNE,"6/19/2018 8 a.m. EDT",15926,16020,13559,-2367
ISNE,"6/19/2018 9 a.m. EDT",16296,16200,14054,-2242
ISNE,"6/19/2018 10 a.m. EDT",16448,16400,14224,-2224
ISNE,"6/19/2018 11 a.m. EDT",16595,16570,14353,-2242
ISNE,"6/19/2018 12 p.m. EDT",16812,16880,14665,-2147
ISNE,"6/19/2018 1 p.m. EDT",16979,17180,15122,-1857
ISNE,"6/19/2018 2 p.m. EDT",17288,17550,15374,-1914
ISNE,"6/19/2018 3 p.m. EDT",17586,17870,15886,-1700
ISNE,"6/19/2018 4 p.m. EDT",18005,18100,16580,-1425
ISNE,"6/19/2018 5 p.m. EDT",18506,18480,16996,-1510
ISNE,"6/19/2018 6 p.m. EDT",18860,18750,16909,-1951
ISNE,"6/19/2018 7 p.m. EDT",18778,18240,16582,-2196
ISNE,"6/19/2018 8 p.m. EDT",18181,17470,15924,-2257
ISNE,"6/19/2018 9 p.m. EDT",17457,17110,15161,-2296
ISNE,"6/19/2018 10 p.m. EDT",16581,16150,14302,-2279
ISNE,"6/19/2018 11 p.m. EDT",14861,14470,12727,-2134
ISNE,"6/20/2018 12 a.m. EDT",13154,12780,10888,-2266
ISNE,"6/20/2018 1 a.m. EDT",12003,11880,9399,-2604
ISNE,"6/20/2018 2 a.m. EDT",11507,11260,8686,-2821
ISNE,"6/20/2018 3 a.m. EDT",11275,10760,8402,-2873
ISNE,"6/20/2018 4 a.m. EDT",11100,10560,8215,-2885
ISNE,"6/20/2018 5 a.m. EDT",11172,10650,8275,-2897
ISNE,"6/20/2018 6 a.m. EDT",11706,11200,8698,-3008
ISNE,"6/20/2018 7 a.m. EDT",12558,12460,9800,-2758
ISNE,"6/20/2018 8 a.m. EDT",13599,13750,11469,-2130
ISNE,"6/20/2018 9 a.m. EDT",14042,14310,11826,-2216
ISNE,"6/20/2018 10 a.m. EDT",14368,14670,12349,-2019
ISNE,"6/20/2018 11 a.m. EDT",14793,15100,13360,-1433
ISNE,"6/20/2018 12 p.m. EDT",15078,15510,13830,-1248
ISNE,"6/20/2018 1 p.m. EDT",15416,15800,14291,-1125
ISNE,"6/20/2018 2 p.m. EDT",16085,16190,15093,-992
ISNE,"6/20/2018 3 p.m. EDT",16589,16620,15551,-1038
ISNE,"6/20/2018 4 p.m. EDT",16934,16940,15681,-1253
ISNE,"6/20/2018 5 p.m. EDT",17178,17360,15765,-1413
ISNE,"6/20/2018 6 p.m. EDT",17270,17560,15395,-1875
ISNE,"6/20/2018 7 p.m. EDT",17100,17170,15229,-1871
ISNE,"6/20/2018 8 p.m. EDT",16873,16830,15237,-1636
ISNE,"6/20/2018 9 p.m. EDT",16687,16580,14928,-1759
ISNE,"6/20/2018 10 p.m. EDT",16119,15940,14598,-1521
ISNE,"6/20/2018 11 p.m. EDT",14678,14550,12889,-1789
ISNE,"6/21/2018 12 a.m. EDT",13190,13090,10782,-2408
ISNE,"6/21/2018 1 a.m. EDT",12235,12130,9591,-2644
ISNE,"6/21/2018 2 a.m. EDT",12004,11460,9438,-2566
ISNE,"6/21/2018 3 a.m. EDT",12060,11060,9623,-2437
ISNE,"6/21/2018 4 a.m. EDT",11937,10880,9462,-2475
ISNE,"6/21/2018 5 a.m. EDT",12067,11030,9452,-2615
ISNE,"6/21/2018 6 a.m. EDT",12270,11630,9639,-2631
ISNE,"6/21/2018 7 a.m. EDT",13117,12990,10699,-2418
ISNE,"6/21/2018 8 a.m. EDT",14097,14120,11916,-2181
ISNE,"6/21/2018 9 a.m. EDT",14587,14590,12558,-2029
ISNE,"6/21/2018 10 a.m. EDT",14933,14870,12926,-2007
ISNE,"6/21/2018 11 a.m. EDT",15301,15300,13368,-1933
ISNE,"6/21/2018 12 p.m. EDT",15736,15660,13607,-2129
ISNE,"6/21/2018 1 p.m. EDT",16183,16110,14038,-2145
ISNE,"6/21/2018 2 p.m. EDT",16666,16360,14302,-2364
ISNE,"6/21/2018 3 p.m. EDT",17055,16980,14905,-2150
ISNE,"6/21/2018 4 p.m. EDT",17288,17470,15162,-2126
ISNE,"6/21/2018 5 p.m. EDT",17565,17540,15218,-2347
ISNE,"6/21/2018 6 p.m. EDT",17650,17550,15239,-2411
ISNE,"6/21/2018 7 p.m. EDT",17448,17200,14936,-2512
ISNE,"6/21/2018 8 p.m. EDT",16988,16770,14587,-2401
ISNE,"6/21/2018 9 p.m. EDT",16575,16160,14002,-2573
ISNE,"6/21/2018 10 p.m. EDT",15961,15550,13589,-2372
ISNE,"6/21/2018 11 p.m. EDT",14485,14120,11859,-2626
ISNE,"6/22/2018 12 a.m. EDT",12943,12520,10331,-2612
ISNE,"6/22/2018 1 a.m. EDT",12057,11800,9822,-2235
ISNE,"6/22/2018 2 a.m. EDT",11801,11090,9793,-2008
ISNE,"6/22/2018 3 a.m. EDT",11689,10650,9875,-1814
ISNE,"6/22/2018 4 a.m. EDT",11726,10420,9809,-1917
ISNE,"6/22/2018 5 a.m. EDT",11799,10490,9571,-2228
ISNE,"6/22/2018 6 a.m. EDT",11990,10960,9675,-2315
ISNE,"6/22/2018 7 a.m. EDT",12649,12120,10551,-2098
ISNE,"6/22/2018 8 a.m. EDT",13070,13090,11200,-1870
ISNE,"6/22/2018 9 a.m. EDT",13489,13500,11613,-1876
ISNE,"6/22/2018 10 a.m. EDT",13755,13780,11857,-1898
ISNE,"6/22/2018 11 a.m. EDT",14051,14010,12464,-1587
ISNE,"6/22/2018 12 p.m. EDT",14376,14230,13012,-1364
ISNE,"6/22/2018 1 p.m. EDT",14648,14370,13051,-1597
ISNE,"6/22/2018 2 p.m. EDT",14954,14670,13123,-1831
ISNE,"6/22/2018 3 p.m. EDT",15175,14980,13101,-2074
ISNE,"6/22/2018 4 p.m. EDT",15424,15090,13555,-1869
ISNE,"6/22/2018 5 p.m. EDT",15624,15260,13499,-2125
ISNE,"6/22/2018 6 p.m. EDT",15647,15380,13114,-2533
ISNE,"6/22/2018 7 p.m. EDT",15285,15030,12711,-2574
ISNE,"6/22/2018 8 p.m. EDT",14862,14670,12352,-2510
ISNE,"6/22/2018 9 p.m. EDT",14656,14450,12144,-2512
ISNE,"6/22/2018 10 p.m. EDT",14200,13980,12095,-2105
ISNE,"6/22/2018 11 p.m. EDT",13091,13040,10830,-2261
ISNE,"6/23/2018 12 a.m. EDT",12047,11830,9468,-2579
ISNE,"6/23/2018 1 a.m. EDT",11282,10960,8500,-2782
ISNE,"6/23/2018 2 a.m. EDT",11106,10370,8319,-2787
ISNE,"6/23/2018 3 a.m. EDT",11011,9990,8022,-2989
ISNE,"6/23/2018 4 a.m. EDT",11059,9820,7945,-3114
ISNE,"6/23/2018 5 a.m. EDT",11161,9830,8009,-3152
ISNE,"6/23/2018 6 a.m. EDT",11314,10000,8350,-2964
ISNE,"6/23/2018 7 a.m. EDT",11521,10500,8549,-2972
ISNE,"6/23/2018 8 a.m. EDT",11950,11250,8951,-2999
ISNE,"6/23/2018 9 a.m. EDT",12094,12070,9362,-2732
ISNE,"6/23/2018 10 a.m. EDT",12654,12650,9883,-2771
ISNE,"6/23/2018 11 a.m. EDT",12925,12980,10119,-2806
ISNE,"6/23/2018 12 p.m. EDT",12973,13200,10314,-2659
ISNE,"6/23/2018 1 p.m. EDT",13010,13220,10562,-2448
ISNE,"6/23/2018 2 p.m. EDT",12867,13210,10444,-2423
ISNE,"6/23/2018 3 p.m. EDT",12738,13210,10275,-2463
ISNE,"6/23/2018 4 p.m. EDT",12649,13200,9774,-2875
ISNE,"6/23/2018 5 p.m. EDT",12712,13320,9827,-2885
ISNE,"6/23/2018 6 p.m. EDT",12903,13550,9895,-3008
ISNE,"6/23/2018 7 p.m. EDT",12944,13460,9798,-3146
ISNE,"6/23/2018 8 p.m. EDT",12869,13350,9698,-3171
ISNE,"6/23/2018 9 p.m. EDT",12862,13210,9818,-3044
ISNE,"6/23/2018 10 p.m. EDT",12499,12920,9575,-2924
ISNE,"6/23/2018 11 p.m. EDT",11707,12130,8554,-3153
ISNE,"6/24/2018 12 a.m. EDT",10807,11220,7776,-3031
ISNE,"6/24/2018 1 a.m. EDT",10106,10430,7966,-2140
ISNE,"6/24/2018 2 a.m. EDT",9893,9920,7903,-1990
ISNE,"6/24/2018 3 a.m. EDT",9857,9640,7721,-2136
ISNE,"6/24/2018 4 a.m. EDT",10013,9450,7788,-2225
ISNE,"6/24/2018 5 a.m. EDT",10033,9570,7522,-2511
ISNE,"6/24/2018 6 a.m. EDT",10079,9470,7585,-2494
ISNE,"6/24/2018 7 a.m. EDT",10155,9780,7680,-2475
ISNE,"6/24/2018 8 a.m. EDT",10554,10360,8323,-2231
ISNE,"6/24/2018 9 a.m. EDT",11347,11120,9128,-2219
ISNE,"6/24/2018 10 a.m. EDT",11774,11710,9712,-2062
ISNE,"6/24/2018 11 a.m. EDT",12181,12200,10084,-2097
ISNE,"6/24/2018 12 p.m. EDT",12429,12620,10536,-1893
ISNE,"6/24/2018 1 p.m. EDT",12770,13050,10993,-1777
ISNE,"6/24/2018 2 p.m. EDT",13199,13350,11614,-1585
ISNE,"6/24/2018 3 p.m. EDT",13669,13780,12324,-1345
ISNE,"6/24/2018 4 p.m. EDT",14058,13960,12743,-1315
ISNE,"6/24/2018 5 p.m. EDT",14573,14600,13227,-1346
ISNE,"6/24/2018 6 p.m. EDT",15149,15060,13658,-1491
ISNE,"6/24/2018 7 p.m. EDT",15279,15020,13480,-1799
ISNE,"6/24/2018 8 p.m. EDT",15188,14990,13401,-1787
ISNE,"6/24/2018 9 p.m. EDT",15050,14750,13136,-1914
ISNE,"6/24/2018 10 p.m. EDT",14510,14290,12578,-1932
ISNE,"6/24/2018 11 p.m. EDT",13412,13230,11097,-2315
ISNE,"6/25/2018 12 a.m. EDT",12275,12030,9703,-2572
ISNE,"6/25/2018 1 a.m. EDT",11537,11420,9118,-2419
ISNE,"6/25/2018 2 a.m. EDT",11170,10880,8887,-2283
ISNE,"6/25/2018 3 a.m. EDT",10859,10560,8780,-2079
ISNE,"6/25/2018 4 a.m. EDT",10740,10440,8677,-2063
ISNE,"6/25/2018 5 a.m. EDT",10937,10660,8804,-2133
ISNE,"6/25/2018 6 a.m. EDT",11550,11290,9493,-2057
ISNE,"6/25/2018 7 a.m. EDT",12812,12560,10476,-2336
ISNE,"6/25/2018 8 a.m. EDT",13988,13730,11742,-2246
ISNE,"6/25/2018 9 a.m. EDT",14656,14380,12563,-2093
ISNE,"6/25/2018 10 a.m. EDT",14573,14570,12743,-1830
ISNE,"6/25/2018 11 a.m. EDT",14615,14610,12587,-2028
ISNE,"6/25/2018 12 p.m. EDT",14634,14620,12422,-2212
ISNE,"6/25/2018 1 p.m. EDT",14538,14550,12569,-1969
ISNE,"6/25/2018 2 p.m. EDT",14614,14610,12550,-2064
ISNE,"6/25/2018 3 p.m. EDT",14664,14670,12638,-2026
ISNE,"6/25/2018 4 p.m. EDT",14784,14780,12911,-1873
ISNE,"6/25/2018 5 p.m. EDT",15173,15180,13318,-1855
ISNE,"6/25/2018 6 p.m. EDT",15587,15810,13768,-1819
ISNE,"6/25/2018 7 p.m. EDT",15691,15880,13751,-1940
ISNE,"6/25/2018 8 p.m. EDT",15357,15380,13067,-2290
ISNE,"6/25/2018 9 p.m. EDT",14953,15040,12606,-2347
ISNE,"6/25/2018 10 p.m. EDT",14366,14290,12090,-2276
ISNE,"6/25/2018 11 p.m. EDT",12992,13000,10547,-2445
ISNE,"6/26/2018 12 a.m. EDT",11609,11570,9308,-2301
ISNE,"6/26/2018 1 a.m. EDT",10666,10700,8326,-2340
ISNE,"6/26/2018 2 a.m. EDT",10471,10130,8273,-2198
ISNE,"6/26/2018 3 a.m. EDT",10786,9790,8448,-2338
ISNE,"6/26/2018 4 a.m. EDT",10962,9710,8491,-2471
ISNE,"6/26/2018 5 a.m. EDT",11394,9900,8744,-2650
ISNE,"6/26/2018 6 a.m. EDT",11433,10540,9213,-2220
ISNE,"6/26/2018 7 a.m. EDT",11940,11710,9896,-2044
ISNE,"6/26/2018 8 a.m. EDT",12541,12810,10681,-1860
ISNE,"6/26/2018 9 a.m. EDT",12887,13200,11017,-1870
ISNE,"6/26/2018 10 a.m. EDT",13034,13020,11383,-1651
ISNE,"6/26/2018 11 a.m. EDT",13249,13250,11837,-1412
ISNE,"6/26/2018 12 p.m. EDT",13445,13540,11746,-1699
ISNE,"6/26/2018 1 p.m. EDT",13596,13790,12059,-1537
ISNE,"6/26/2018 2 p.m. EDT",13946,14040,12435,-1511
ISNE,"6/26/2018 3 p.m. EDT",14254,14600,12861,-1393
ISNE,"6/26/2018 4 p.m. EDT",14666,15080,13503,-1163
ISNE,"6/26/2018 5 p.m. EDT",15223,15750,14210,-1013
ISNE,"6/26/2018 6 p.m. EDT",15754,16120,14639,-1115
ISNE,"6/26/2018 7 p.m. EDT",15867,15890,14063,-1804
ISNE,"6/26/2018 8 p.m. EDT",15524,15550,13600,-1924
ISNE,"6/26/2018 9 p.m. EDT",15264,15550,13059,-2205
ISNE,"6/26/2018 10 p.m. EDT",14739,14830,12497,-2242
ISNE,"6/26/2018 11 p.m. EDT",13420,13490,11005,-2415
ISNE,"6/27/2018 12 a.m. EDT",12321,12060,10004,-2317
ISNE,"6/27/2018 1 a.m. EDT",11555,11020,9504,-2051
ISNE,"6/27/2018 2 a.m. EDT",11088,10480,9120,-1968
ISNE,"6/27/2018 3 a.m. EDT",10765,10180,8741,-2024
ISNE,"6/27/2018 4 a.m. EDT",10914,10110,8683,-2231
ISNE,"6/27/2018 5 a.m. EDT",11106,10330,8649,-2457
ISNE,"6/27/2018 6 a.m. EDT",11696,10990,9355,-2341
ISNE,"6/27/2018 7 a.m. EDT",12602,12280,10316,-2286
ISNE,"6/27/2018 8 a.m. EDT",13254,13520,11298,-1956
ISNE,"6/27/2018 9 a.m. EDT",13805,14050,12203,-1602
ISNE,"6/27/2018 10 a.m. EDT",14137,14180,12487,-1650
ISNE,"6/27/2018 11 a.m. EDT",14428,14580,12854,-1574
ISNE,"6/27/2018 12 p.m. EDT",14709,14960,13083,-1626
ISNE,"6/27/2018 1 p.m. EDT",14922,15090,13210,-1712
ISNE,"6/27/2018 2 p.m. EDT",15370,15480,13545,-1825
ISNE,"6/27/2018 3 p.m. EDT",15692,15630,13994,-1698
ISNE,"6/27/2018 4 p.m. EDT",15777,15700,14167,-1610
ISNE,"6/27/2018 5 p.m. EDT",15759,15860,14037,-1722
ISNE,"6/27/2018 6 p.m. EDT",15756,16150,13649,-2107
ISNE,"6/27/2018 7 p.m. EDT",15576,15870,13307,-2269
ISNE,"6/27/2018 8 p.m. EDT",15373,15680,13089,-2284
ISNE,"6/27/2018 9 p.m. EDT",15287,15450,12908,-2379
ISNE,"6/27/2018 10 p.m. EDT",14692,14910,12459,-2233
ISNE,"6/27/2018 11 p.m. EDT",13482,13690,11194,-2288
ISNE,"6/28/2018 12 a.m. EDT",12300,12350,9674,-2626
ISNE,"6/28/2018 1 a.m. EDT",11701,11400,9002,-2699
ISNE,"6/28/2018 2 a.m. EDT",11454,10910,9038,-2416
ISNE,"6/28/2018 3 a.m. EDT",11498,10660,9215,-2283
ISNE,"6/28/2018 4 a.m. EDT",11664,10600,9202,-2462
ISNE,"6/28/2018 5 a.m. EDT",11872,10900,9184,-2688
ISNE,"6/28/2018 6 a.m. EDT",12208,11750,9696,-2512
ISNE,"6/28/2018 7 a.m. EDT",13115,13370,10645,-2470
ISNE,"6/28/2018 8 a.m. EDT",14484,14660,11932,-2552
ISNE,"6/28/2018 9 a.m. EDT",15356,15520,13193,-2163
ISNE,"6/28/2018 10 a.m. EDT",15908,16010,13788,-2120
ISNE,"6/28/2018 11 a.m. EDT",16251,16280,14214,-2037
ISNE,"6/28/2018 12 p.m. EDT",16415,16460,14479,-1936
ISNE,"6/28/2018 1 p.m. EDT",16530,16660,14814,-1716
ISNE,"6/28/2018 2 p.m. EDT",16673,16800,15049,-1624
ISNE,"6/28/2018 3 p.m. EDT",16833,16960,15222,-1611
ISNE,"6/28/2018 4 p.m. EDT",16888,17150,15520,-1368
ISNE,"6/28/2018 5 p.m. EDT",16982,17330,15926,-1056
ISNE,"6/28/2018 6 p.m. EDT",17119,17700,15963,-1156
ISNE,"6/28/2018 7 p.m. EDT",17030,17580,15484,-1546
ISNE,"6/28/2018 8 p.m. EDT",16814,17260,14893,-1921
ISNE,"6/28/2018 9 p.m. EDT",16625,17080,14533,-2092
ISNE,"6/28/2018 10 p.m. EDT",16189,16490,14531,-1658
ISNE,"6/28/2018 11 p.m. EDT",14904,14950,12866,-2038
ISNE,"6/29/2018 12 a.m. EDT",13541,13580,11059,-2482
ISNE,"6/29/2018 1 a.m. EDT",12917,12600,10346,-2571
ISNE,"6/29/2018 2 a.m. EDT",12542,11930,10198,-2344
ISNE,"6/29/2018 3 a.m. EDT",12699,11520,10303,-2396
ISNE,"6/29/2018 4 a.m. EDT",12512,11300,10218,-2294
ISNE,"6/29/2018 5 a.m. EDT",12616,11400,9934,-2682
ISNE,"6/29/2018 6 a.m. EDT",13078,11980,10387,-2691
ISNE,"6/29/2018 7 a.m. EDT",13664,13360,11128,-2536
ISNE,"6/29/2018 8 a.m. EDT",14845,14830,12504,-2341
ISNE,"6/29/2018 9 a.m. EDT",15620,15740,13818,-1802
ISNE,"6/29/2018 10 a.m. EDT",16303,16310,14574,-1729
ISNE,"6/29/2018 11 a.m. EDT",16982,17020,15168,-1814
ISNE,"6/29/2018 12 p.m. EDT",17630,17680,15849,-1781
ISNE,"6/29/2018 1 p.m. EDT",18115,18200,15724,-2391
ISNE,"6/29/2018 2 p.m. EDT",18837,18940,16453,-2384
ISNE,"6/29/2018 3 p.m. EDT",19309,19360,17319,-1990
ISNE,"6/29/2018 4 p.m. EDT",19641,19980,17776,-1865
ISNE,"6/29/2018 5 p.m. EDT",20037,20480,17946,-2091
ISNE,"6/29/2018 6 p.m. EDT",20399,20500,18440,-1959
ISNE,"6/29/2018 7 p.m. EDT",20345,19990,18167,-2178
ISNE,"6/29/2018 8 p.m. EDT",19730,19270,16987,-2743
ISNE,"6/29/2018 9 p.m. EDT",19000,18860,15892,-3108
ISNE,"6/29/2018 10 p.m. EDT",18190,18200,15632,-2558
ISNE,"6/29/2018 11 p.m. EDT",16710,16740,14447,-2263
ISNE,"6/30/2018 12 a.m. EDT",15379,15080,12910,-2469
ISNE,"6/30/2018 1 a.m. EDT",14113,13840,11649,-2464
ISNE,"6/30/2018 2 a.m. EDT",13474,12890,10874,-2600
ISNE,"6/30/2018 3 a.m. EDT",13238,12380,10485,-2753
ISNE,"6/30/2018 4 a.m. EDT",13293,11960,10427,-2866
ISNE,"6/30/2018 5 a.m. EDT",13129,11790,10399,-2730
ISNE,"6/30/2018 6 a.m. EDT",13365,11880,10467,-2898
ISNE,"6/30/2018 7 a.m. EDT",13609,12470,10658,-2951
ISNE,"6/30/2018 8 a.m. EDT",14012,13460,11290,-2722
ISNE,"6/30/2018 9 a.m. EDT",14502,14830,12286,-2216
ISNE,"6/30/2018 10 a.m. EDT",15673,15600,13646,-2027
ISNE,"6/30/2018 11 a.m. EDT",16678,16410,14432,-2246
ISNE,"6/30/2018 12 p.m. EDT",17439,17110,15266,-2173
ISNE,"6/30/2018 1 p.m. EDT",17979,17830,15825,-2154
ISNE,"6/30/2018 2 p.m. EDT",18526,18480,16495,-2031
ISNE,"6/30/2018 3 p.m. EDT",18988,19040,17120,-1868
ISNE,"6/30/2018 4 p.m. EDT",19385,19670,17613,-1772
ISNE,"6/30/2018 5 p.m. EDT",19837,20080,18126,-1711
ISNE,"6/30/2018 6 p.m. EDT",20292,20200,18036,-2256
ISNE,"6/30/2018 7 p.m. EDT",20399,20130,17902,-2497
ISNE,"6/30/2018 8 p.m. EDT",19914,19520,16955,-2959
ISNE,"6/30/2018 9 p.m. EDT",19355,19030,16769,-2586
ISNE,"6/30/2018 10 p.m. EDT",18770,18530,16293,-2477
ISNE,"6/30/2018 11 p.m. EDT",17421,17080,15376,-2045
ISNE,"7/1/2018 12 a.m. EDT",16406,15650,14146,-2260
