"BA Code","Timestamp (Hour Ending)","Demand (MWh)","Demand Forecast (MWh)","Net Generation (MWh)","Total Interchange (MWh)"
ISNE,"4/1/2018 12 a.m. EDT",10991,11000,8942,-2049
ISNE,"4/1/2018 1 a.m. EDT",10401,10250,8834,-1567
ISNE,"4/1/2018 2 a.m. EDT",10345,9810,8605,-1740
ISNE,"4/1/2018 3 a.m. EDT",10342,9570,8426,-1916
ISNE,"4/1/2018 4 a.m. EDT",10280,9460,8444,-1836
ISNE,"4/1/2018 5 a.m. EDT",10332,9520,8419,-1913
ISNE,"4/1/2018 6 a.m. EDT",10304,9770,8526,-1778
ISNE,"4/1/2018 7 a.m. EDT",10488,10260,8724,-1764
ISNE,"4/1/2018 8 a.m. EDT",11146,10970,9278,-1868
ISNE,"4/1/2018 9 a.m. EDT",11688,11680,9720,-1968
ISNE,"4/1/2018 10 a.m. EDT",11897,12000,10215,-1682
ISNE,"4/1/2018 11 a.m. EDT",11756,11960,10090,-1666
ISNE,"4/1/2018 12 p.m. EDT",11546,11620,9745,-1801
ISNE,"4/1/2018 1 p.m. EDT",11317,11130,9439,-1878
ISNE,"4/1/2018 2 p.m. EDT",10918,10490,9085,-1833
ISNE,"4/1/2018 3 p.m. EDT",10571,10140,8501,-2070
ISNE,"4/1/2018 4 p.m. EDT",10539,10170,8434,-2105
ISNE,"4/1/2018 5 p.m. EDT",10781,10620,8733,-2048
ISNE,"4/1/2018 6 p.m. EDT",10983,11020,9104,-1879
ISNE,"4/1/2018 7 p.m. EDT",11724,11870,9798,-1926
ISNE,"4/1/2018 8 p.m. EDT",12798,12860,11136,-1662
ISNE,"4/1/2018 9 p.m. EDT",13074,13500,11476,-1598
ISNE,"4/1/2018 10 p.m. EDT",12519,12750,10679,-1840
ISNE,"4/1/2018 11 p.m. EDT",11630,11830,9771,-1859
ISNE,"4/2/2018 12 a.m. EDT",10757,10850,8878,-1879
ISNE,"4/2/2018 1 a.m. EDT",10514,10210,8618,-1896
ISNE,"4/2/2018 2 a.m. EDT",10520,9970,8530,-1990
ISNE,"4/2/2018 3 a.m. EDT",10418,9890,8543,-1875
ISNE,"4/2/2018 4 a.m. EDT",10472,9950,8497,-1975
ISNE,"4/2/2018 5 a.m. EDT",10856,10340,8822,-2034
ISNE,"4/2/2018 6 a.m. EDT",11987,11460,9802,-2185
ISNE,"4/2/2018 7 a.m. EDT",13374,13260,11119,-2255
ISNE,"4/2/2018 8 a.m. EDT",14423,14410,12194,-2229
ISNE,"4/2/2018 9 a.m. EDT",14907,14900,12492,-2415
ISNE,"4/2/2018 10 a.m. EDT",15191,15190,12623,-2568
ISNE,"4/2/2018 11 a.m. EDT",15288,15220,12696,-2592
ISNE,"4/2/2018 12 p.m. EDT",15087,15110,12563,-2524
ISNE,"4/2/2018 1 p.m. EDT",14650,14810,12119,-2531
ISNE,"4/2/2018 2 p.m. EDT",14213,14590,11666,-2547
ISNE,"4/2/2018 3 p.m. EDT",13916,14200,11433,-2483
ISNE,"4/2/2018 4 p.m. EDT",13853,13880,11472,-2381
ISNE,"4/2/2018 5 p.m. EDT",13772,14050,11468,-2304
ISNE,"4/2/2018 6 p.m. EDT",13927,14390,11556,-2371
ISNE,"4/2/2018 7 p.m. EDT",14518,14790,12132,-2386
ISNE,"4/2/2018 8 p.m. EDT",15192,15300,12846,-2346
ISNE,"4/2/2018 9 p.m. EDT",15088,15040,12740,-2348
ISNE,"4/2/2018 10 p.m. EDT",14185,14000,11706,-2479
ISNE,"4/2/2018 11 p.m. EDT",12938,12740,10346,-2592
ISNE,"4/3/2018 12 a.m. EDT",11839,11550,9440,-2399
ISNE,"4/3/2018 1 a.m. EDT",11396,11140,9234,-2162
ISNE,"4/3/2018 2 a.m. EDT",11345,10800,9163,-2182
ISNE,"4/3/2018 3 a.m. EDT",11230,10690,8855,-2375
ISNE,"4/3/2018 4 a.m. EDT",11271,10740,8830,-2441
ISNE,"4/3/2018 5 a.m. EDT",11422,11140,9004,-2418
ISNE,"4/3/2018 6 a.m. EDT",12176,12200,9853,-2323
ISNE,"4/3/2018 7 a.m. EDT",13896,13920,11654,-2242
ISNE,"4/3/2018 8 a.m. EDT",14685,14670,12670,-2015
ISNE,"4/3/2018 9 a.m. EDT",14328,14280,12223,-2105
ISNE,"4/3/2018 10 a.m. EDT",13751,13850,11551,-2200
ISNE,"4/3/2018 11 a.m. EDT",13864,13780,11658,-2206
ISNE,"4/3/2018 12 p.m. EDT",14087,13770,11939,-2148
ISNE,"4/3/2018 1 p.m. EDT",14252,13710,12197,-2055
ISNE,"4/3/2018 2 p.m. EDT",14439,13890,12365,-2074
ISNE,"4/3/2018 3 p.m. EDT",14386,13920,12187,-2199
ISNE,"4/3/2018 4 p.m. EDT",14514,14250,12311,-2203
ISNE,"4/3/2018 5 p.m. EDT",14854,14590,12534,-2320
ISNE,"4/3/2018 6 p.m. EDT",15363,14970,13184,-2179
ISNE,"4/3/2018 7 p.m. EDT",15529,15010,13141,-2388
ISNE,"4/3/2018 8 p.m. EDT",15568,15390,13056,-2512
ISNE,"4/3/2018 9 p.m. EDT",15157,14970,12919,-2238
ISNE,"4/3/2018 10 p.m. EDT",14176,13980,11997,-2179
ISNE,"4/3/2018 11 p.m. EDT",13114,12670,10945,-2169
ISNE,"4/4/2018 12 a.m. EDT",12284,11480,9867,-2417
ISNE,"4/4/2018 1 a.m. EDT",11377,10960,8871,-2506
ISNE,"4/4/2018 2 a.m. EDT",11059,10560,8521,-2538
ISNE,"4/4/2018 3 a.m. EDT",10924,10390,8478,-2446
ISNE,"4/4/2018 4 a.m. EDT",10903,10370,8433,-2470
ISNE,"4/4/2018 5 a.m. EDT",11210,10690,8747,-2463
ISNE,"4/4/2018 6 a.m. EDT",11760,11680,9167,-2593
ISNE,"4/4/2018 7 a.m. EDT",13411,13440,10731,-2680
ISNE,"4/4/2018 8 a.m. EDT",14477,14480,11826,-2651
ISNE,"4/4/2018 9 a.m. EDT",14682,14660,12060,-2622
ISNE,"4/4/2018 10 a.m. EDT",14694,14730,12039,-2655
ISNE,"4/4/2018 11 a.m. EDT",14673,14780,12116,-2557
ISNE,"4/4/2018 12 p.m. EDT",14570,14670,12155,-2415
ISNE,"4/4/2018 1 p.m. EDT",14479,14520,11937,-2542
ISNE,"4/4/2018 2 p.m. EDT",14827,14300,12188,-2639
ISNE,"4/4/2018 3 p.m. EDT",14715,14080,12024,-2691
ISNE,"4/4/2018 4 p.m. EDT",14612,14040,11945,-2667
ISNE,"4/4/2018 5 p.m. EDT",14675,14160,12022,-2653
ISNE,"4/4/2018 6 p.m. EDT",14705,14250,12118,-2587
ISNE,"4/4/2018 7 p.m. EDT",14668,14490,12112,-2556
ISNE,"4/4/2018 8 p.m. EDT",14823,14950,12303,-2520
ISNE,"4/4/2018 9 p.m. EDT",14727,14930,12274,-2453
ISNE,"4/4/2018 10 p.m. EDT",13883,13980,11440,-2443
ISNE,"4/4/2018 11 p.m. EDT",12684,12770,10110,-2574
ISNE,"4/5/2018 12 a.m. EDT",11837,11740,9406,-2431
ISNE,"4/5/2018 1 a.m. EDT",11253,11250,9073,-2180
ISNE,"4/5/2018 2 a.m. EDT",11337,10950,8810,-2527
ISNE,"4/5/2018 3 a.m. EDT",11373,10880,8825,-2548
ISNE,"4/5/2018 4 a.m. EDT",11691,10620,9162,-2529
ISNE,"4/5/2018 5 a.m. EDT",11906,11030,9411,-2495
ISNE,"4/5/2018 6 a.m. EDT",12728,12270,10358,-2370
ISNE,"4/5/2018 7 a.m. EDT",13999,14000,11865,-2134
ISNE,"4/5/2018 8 a.m. EDT",14662,14770,12547,-2115
ISNE,"4/5/2018 9 a.m. EDT",14168,14140,11892,-2276
ISNE,"4/5/2018 10 a.m. EDT",13791,13510,11472,-2319
ISNE,"4/5/2018 11 a.m. EDT",13723,13190,11427,-2296
ISNE,"4/5/2018 12 p.m. EDT",13753,13010,11417,-2336
ISNE,"4/5/2018 1 p.m. EDT",13473,12830,11150,-2323
ISNE,"4/5/2018 2 p.m. EDT",13549,12590,11211,-2338
ISNE,"4/5/2018 3 p.m. EDT",13414,12560,11070,-2344
ISNE,"4/5/2018 4 p.m. EDT",13460,12630,11121,-2339
ISNE,"4/5/2018 5 p.m. EDT",13520,13360,11166,-2354
ISNE,"4/5/2018 6 p.m. EDT",14011,13770,11633,-2378
ISNE,"4/5/2018 7 p.m. EDT",14609,14610,12249,-2360
ISNE,"4/5/2018 8 p.m. EDT",15117,15370,12774,-2343
ISNE,"4/5/2018 9 p.m. EDT",15158,15580,12867,-2291
ISNE,"4/5/2018 10 p.m. EDT",14431,14620,12152,-2279
ISNE,"4/5/2018 11 p.m. EDT",13268,13470,11001,-2267
ISNE,"4/6/2018 12 a.m. EDT",12404,12390,10075,-2329
ISNE,"4/6/2018 1 a.m. EDT",11790,11480,9514,-2276
ISNE,"4/6/2018 2 a.m. EDT",11435,11110,9081,-2354
ISNE,"4/6/2018 3 a.m. EDT",11314,10980,8957,-2357
ISNE,"4/6/2018 4 a.m. EDT",11351,11080,8861,-2490
ISNE,"4/6/2018 5 a.m. EDT",11715,11410,9370,-2345
ISNE,"4/6/2018 6 a.m. EDT",12514,12380,10137,-2377
ISNE,"4/6/2018 7 a.m. EDT",14115,14060,11646,-2469
ISNE,"4/6/2018 8 a.m. EDT",14800,14800,12321,-2479
ISNE,"4/6/2018 9 a.m. EDT",14559,14750,12095,-2464
ISNE,"4/6/2018 10 a.m. EDT",14350,14450,11847,-2503
ISNE,"4/6/2018 11 a.m. EDT",14360,14260,11890,-2470
ISNE,"4/6/2018 12 p.m. EDT",14513,14230,12023,-2490
ISNE,"4/6/2018 1 p.m. EDT",14737,14160,12263,-2474
ISNE,"4/6/2018 2 p.m. EDT",14942,14120,12519,-2423
ISNE,"4/6/2018 3 p.m. EDT",14961,14060,12530,-2431
ISNE,"4/6/2018 4 p.m. EDT",14887,14000,12535,-2352
ISNE,"4/6/2018 5 p.m. EDT",14739,14170,12389,-2350
ISNE,"4/6/2018 6 p.m. EDT",14669,14450,12210,-2459
ISNE,"4/6/2018 7 p.m. EDT",14573,14240,12055,-2518
ISNE,"4/6/2018 8 p.m. EDT",14751,14600,12287,-2464
ISNE,"4/6/2018 9 p.m. EDT",14523,14330,11978,-2545
ISNE,"4/6/2018 10 p.m. EDT",13787,13650,11452,-2335
ISNE,"4/6/2018 11 p.m. EDT",12753,12600,10605,-2148
ISNE,"4/7/2018 12 a.m. EDT",11746,11630,9466,-2280
ISNE,"4/7/2018 1 a.m. EDT",11252,10980,8951,-2301
ISNE,"4/7/2018 2 a.m. EDT",10965,10520,8681,-2284
ISNE,"4/7/2018 3 a.m. EDT",10812,10290,8674,-2138
ISNE,"4/7/2018 4 a.m. EDT",10735,10210,8581,-2154
ISNE,"4/7/2018 5 a.m. EDT",10839,10330,8556,-2283
ISNE,"4/7/2018 6 a.m. EDT",11186,10750,9015,-2171
ISNE,"4/7/2018 7 a.m. EDT",11569,11510,9443,-2126
ISNE,"4/7/2018 8 a.m. EDT",12359,12390,10176,-2183
ISNE,"4/7/2018 9 a.m. EDT",13203,13230,11015,-2188
ISNE,"4/7/2018 10 a.m. EDT",13488,13500,11242,-2246
ISNE,"4/7/2018 11 a.m. EDT",13063,13470,10841,-2222
ISNE,"4/7/2018 12 p.m. EDT",12568,13120,10346,-2222
ISNE,"4/7/2018 1 p.m. EDT",12109,12880,9938,-2171
ISNE,"4/7/2018 2 p.m. EDT",11993,12580,9710,-2283
ISNE,"4/7/2018 3 p.m. EDT",11726,12310,9591,-2135
ISNE,"4/7/2018 4 p.m. EDT",11486,12240,9345,-2141
ISNE,"4/7/2018 5 p.m. EDT",12105,12280,9939,-2166
ISNE,"4/7/2018 6 p.m. EDT",12510,12650,10362,-2148
ISNE,"4/7/2018 7 p.m. EDT",12876,12960,10765,-2111
ISNE,"4/7/2018 8 p.m. EDT",13489,13690,11414,-2075
ISNE,"4/7/2018 9 p.m. EDT",13540,13710,11469,-2071
ISNE,"4/7/2018 10 p.m. EDT",13030,13300,10958,-2072
ISNE,"4/7/2018 11 p.m. EDT",12296,12510,10188,-2108
ISNE,"4/8/2018 12 a.m. EDT",11515,11700,9293,-2222
ISNE,"4/8/2018 1 a.m. EDT",11138,11180,8777,-2361
ISNE,"4/8/2018 2 a.m. EDT",10774,10630,8412,-2362
ISNE,"4/8/2018 3 a.m. EDT",10614,10540,8368,-2246
ISNE,"4/8/2018 4 a.m. EDT",10570,10460,8401,-2169
ISNE,"4/8/2018 5 a.m. EDT",10674,10580,8491,-2183
ISNE,"4/8/2018 6 a.m. EDT",10986,11010,8938,-2048
ISNE,"4/8/2018 7 a.m. EDT",11458,11450,9301,-2157
ISNE,"4/8/2018 8 a.m. EDT",11887,12030,9624,-2263
ISNE,"4/8/2018 9 a.m. EDT",12312,12270,10124,-2188
ISNE,"4/8/2018 10 a.m. EDT",12402,12160,10211,-2191
ISNE,"4/8/2018 11 a.m. EDT",12454,12160,10251,-2203
ISNE,"4/8/2018 12 p.m. EDT",12187,12000,9997,-2190
ISNE,"4/8/2018 1 p.m. EDT",12042,11920,9847,-2195
ISNE,"4/8/2018 2 p.m. EDT",11919,11730,9731,-2188
ISNE,"4/8/2018 3 p.m. EDT",11805,11690,9551,-2254
ISNE,"4/8/2018 4 p.m. EDT",11986,11840,9724,-2262
ISNE,"4/8/2018 5 p.m. EDT",12391,12380,10076,-2315
ISNE,"4/8/2018 6 p.m. EDT",13095,12700,10771,-2324
ISNE,"4/8/2018 7 p.m. EDT",13642,13860,11384,-2258
ISNE,"4/8/2018 8 p.m. EDT",14297,14750,12154,-2143
ISNE,"4/8/2018 9 p.m. EDT",14257,14800,12114,-2143
ISNE,"4/8/2018 10 p.m. EDT",13494,13570,11253,-2241
ISNE,"4/8/2018 11 p.m. EDT",12463,12570,10101,-2362
ISNE,"4/9/2018 12 a.m. EDT",11778,11600,9377,-2401
ISNE,"4/9/2018 1 a.m. EDT",11511,10960,8998,-2513
ISNE,"4/9/2018 2 a.m. EDT",11217,10680,8678,-2539
ISNE,"4/9/2018 3 a.m. EDT",11154,10600,8679,-2475
ISNE,"4/9/2018 4 a.m. EDT",11262,10730,8757,-2505
ISNE,"4/9/2018 5 a.m. EDT",11695,11180,9312,-2383
ISNE,"4/9/2018 6 a.m. EDT",12402,12330,10204,-2198
ISNE,"4/9/2018 7 a.m. EDT",13935,14180,11750,-2185
ISNE,"4/9/2018 8 a.m. EDT",14608,15070,12414,-2194
ISNE,"4/9/2018 9 a.m. EDT",14190,14370,11919,-2271
ISNE,"4/9/2018 10 a.m. EDT",13643,13610,11301,-2342
ISNE,"4/9/2018 11 a.m. EDT",13212,13210,10935,-2277
ISNE,"4/9/2018 12 p.m. EDT",12936,13000,10626,-2310
ISNE,"4/9/2018 1 p.m. EDT",12598,12620,10349,-2249
ISNE,"4/9/2018 2 p.m. EDT",12554,12450,10287,-2267
ISNE,"4/9/2018 3 p.m. EDT",12305,12320,10265,-2040
ISNE,"4/9/2018 4 p.m. EDT",12330,12470,10309,-2021
ISNE,"4/9/2018 5 p.m. EDT",12810,12900,10773,-2037
ISNE,"4/9/2018 6 p.m. EDT",13500,13710,11391,-2109
ISNE,"4/9/2018 7 p.m. EDT",14209,14370,11921,-2288
ISNE,"4/9/2018 8 p.m. EDT",14849,15150,12516,-2333
ISNE,"4/9/2018 9 p.m. EDT",14795,15030,12509,-2286
ISNE,"4/9/2018 10 p.m. EDT",13896,14120,11605,-2291
ISNE,"4/9/2018 11 p.m. EDT",12673,12890,10439,-2234
ISNE,"4/10/2018 12 a.m. EDT",11626,11830,9230,-2396
ISNE,"4/10/2018 1 a.m. EDT",10935,11010,8682,-2253
ISNE,"4/10/2018 2 a.m. EDT",10617,10610,8392,-2225
ISNE,"4/10/2018 3 a.m. EDT",10725,10510,8580,-2145
ISNE,"4/10/2018 4 a.m. EDT",10738,10520,8690,-2048
ISNE,"4/10/2018 5 a.m. EDT",11096,10880,9029,-2067
ISNE,"4/10/2018 6 a.m. EDT",11888,11890,9899,-1989
ISNE,"4/10/2018 7 a.m. EDT",13521,13650,11678,-1843
ISNE,"4/10/2018 8 a.m. EDT",14444,14530,12582,-1862
ISNE,"4/10/2018 9 a.m. EDT",14526,14460,12543,-1983
ISNE,"4/10/2018 10 a.m. EDT",14459,14340,12367,-2092
ISNE,"4/10/2018 11 a.m. EDT",14490,14160,12353,-2137
ISNE,"4/10/2018 12 p.m. EDT",14400,14120,12192,-2208
ISNE,"4/10/2018 1 p.m. EDT",14193,13840,11987,-2206
ISNE,"4/10/2018 2 p.m. EDT",14054,13780,11898,-2156
ISNE,"4/10/2018 3 p.m. EDT",13841,13650,11732,-2109
ISNE,"4/10/2018 4 p.m. EDT",13728,13770,11643,-2085
ISNE,"4/10/2018 5 p.m. EDT",13924,13900,11879,-2045
ISNE,"4/10/2018 6 p.m. EDT",14348,14210,12289,-2059
ISNE,"4/10/2018 7 p.m. EDT",14648,14490,12570,-2078
ISNE,"4/10/2018 8 p.m. EDT",15025,15070,12964,-2061
ISNE,"4/10/2018 9 p.m. EDT",14968,14870,12978,-1990
ISNE,"4/10/2018 10 p.m. EDT",14119,14040,12141,-1978
ISNE,"4/10/2018 11 p.m. EDT",12908,12750,10832,-2076
ISNE,"4/11/2018 12 a.m. EDT",11857,11640,9609,-2248
ISNE,"4/11/2018 1 a.m. EDT",11223,10960,8978,-2245
ISNE,"4/11/2018 2 a.m. EDT",11193,10620,9057,-2136
ISNE,"4/11/2018 3 a.m. EDT",11121,10530,8953,-2168
ISNE,"4/11/2018 4 a.m. EDT",11110,10840,8898,-2212
ISNE,"4/11/2018 5 a.m. EDT",11413,11230,9286,-2127
ISNE,"4/11/2018 6 a.m. EDT",12330,12170,10431,-1899
ISNE,"4/11/2018 7 a.m. EDT",13980,13570,12032,-1948
ISNE,"4/11/2018 8 a.m. EDT",14633,14230,12737,-1896
ISNE,"4/11/2018 9 a.m. EDT",14110,13850,12177,-1933
ISNE,"4/11/2018 10 a.m. EDT",13316,13280,11313,-2003
ISNE,"4/11/2018 11 a.m. EDT",12820,12770,10750,-2070
ISNE,"4/11/2018 12 p.m. EDT",12602,12500,10402,-2200
ISNE,"4/11/2018 1 p.m. EDT",12401,12340,10158,-2243
ISNE,"4/11/2018 2 p.m. EDT",12359,12340,10099,-2260
ISNE,"4/11/2018 3 p.m. EDT",12592,12330,10308,-2284
ISNE,"4/11/2018 4 p.m. EDT",12812,12480,10545,-2267
ISNE,"4/11/2018 5 p.m. EDT",13185,12800,10866,-2319
ISNE,"4/11/2018 6 p.m. EDT",13523,13430,11172,-2351
ISNE,"4/11/2018 7 p.m. EDT",13920,13930,11584,-2336
ISNE,"4/11/2018 8 p.m. EDT",14485,14610,12189,-2296
ISNE,"4/11/2018 9 p.m. EDT",14544,14510,12361,-2183
ISNE,"4/11/2018 10 p.m. EDT",13717,13780,11452,-2265
ISNE,"4/11/2018 11 p.m. EDT",12528,12560,10244,-2284
ISNE,"4/12/2018 12 a.m. EDT",11637,11450,9361,-2276
ISNE,"4/12/2018 1 a.m. EDT",11072,10790,8782,-2290
ISNE,"4/12/2018 2 a.m. EDT",10960,10440,8626,-2334
ISNE,"4/12/2018 3 a.m. EDT",10884,10320,8550,-2334
ISNE,"4/12/2018 4 a.m. EDT",10909,10360,8604,-2305
ISNE,"4/12/2018 5 a.m. EDT",11288,10750,9119,-2169
ISNE,"4/12/2018 6 a.m. EDT",12006,11820,10031,-1975
ISNE,"4/12/2018 7 a.m. EDT",13388,13410,11415,-1973
ISNE,"4/12/2018 8 a.m. EDT",13975,13960,11879,-2096
ISNE,"4/12/2018 9 a.m. EDT",13466,13430,11401,-2065
ISNE,"4/12/2018 10 a.m. EDT",12819,12900,10897,-1922
ISNE,"4/12/2018 11 a.m. EDT",12576,12660,10827,-1749
ISNE,"4/12/2018 12 p.m. EDT",12572,12640,10747,-1825
ISNE,"4/12/2018 1 p.m. EDT",12555,12690,11092,-1463
ISNE,"4/12/2018 2 p.m. EDT",12626,12670,11220,-1406
ISNE,"4/12/2018 3 p.m. EDT",12801,12730,11459,-1342
ISNE,"4/12/2018 4 p.m. EDT",13082,13050,11449,-1633
ISNE,"4/12/2018 5 p.m. EDT",13419,13280,11601,-1818
ISNE,"4/12/2018 6 p.m. EDT",13871,13730,11915,-1956
ISNE,"4/12/2018 7 p.m. EDT",14201,13940,12071,-2130
ISNE,"4/12/2018 8 p.m. EDT",14473,14400,12434,-2039
ISNE,"4/12/2018 9 p.m. EDT",14186,14250,12216,-1970
ISNE,"4/12/2018 10 p.m. EDT",13307,13350,11295,-2012
ISNE,"4/12/2018 11 p.m. EDT",12165,12170,10286,-1879
ISNE,"4/13/2018 12 a.m. EDT",11304,11040,9138,-2166
ISNE,"4/13/2018 1 a.m. EDT",10840,10310,8780,-2060
ISNE,"4/13/2018 2 a.m. EDT",10725,9930,8737,-1988
ISNE,"4/13/2018 3 a.m. EDT",10587,9720,8422,-2165
ISNE,"4/13/2018 4 a.m. EDT",10762,9700,8584,-2178
ISNE,"4/13/2018 5 a.m. EDT",10535,10000,8530,-2005
ISNE,"4/13/2018 6 a.m. EDT",11167,10960,9093,-2074
ISNE,"4/13/2018 7 a.m. EDT",12388,12410,10260,-2128
ISNE,"4/13/2018 8 a.m. EDT",13125,13130,10873,-2252
ISNE,"4/13/2018 9 a.m. EDT",13253,13230,11182,-2071
ISNE,"4/13/2018 10 a.m. EDT",13443,13430,11382,-2061
ISNE,"4/13/2018 11 a.m. EDT",13423,13320,11421,-2002
ISNE,"4/13/2018 12 p.m. EDT",13202,13190,10977,-2225
ISNE,"4/13/2018 1 p.m. EDT",13024,12920,10828,-2196
ISNE,"4/13/2018 2 p.m. EDT",12826,12860,10522,-2304
ISNE,"4/13/2018 3 p.m. EDT",12859,12720,10451,-2408
ISNE,"4/13/2018 4 p.m. EDT",12728,12720,10348,-2380
ISNE,"4/13/2018 5 p.m. EDT",12528,12720,10186,-2342
ISNE,"4/13/2018 6 p.m. EDT",12612,12900,10374,-2238
ISNE,"4/13/2018 7 p.m. EDT",12837,13100,10653,-2184
ISNE,"4/13/2018 8 p.m. EDT",13206,13410,10999,-2207
ISNE,"4/13/2018 9 p.m. EDT",13191,13400,11100,-2091
ISNE,"4/13/2018 10 p.m. EDT",12519,12850,10366,-2153
ISNE,"4/13/2018 11 p.m. EDT",11576,11760,9407,-2169
ISNE,"4/14/2018 12 a.m. EDT",10848,10730,8765,-2083
ISNE,"4/14/2018 1 a.m. EDT",10472,9880,8294,-2178
ISNE,"4/14/2018 2 a.m. EDT",10334,9450,8304,-2030
ISNE,"4/14/2018 3 a.m. EDT",10486,9270,8461,-2025
ISNE,"4/14/2018 4 a.m. EDT",10494,9190,8328,-2166
ISNE,"4/14/2018 5 a.m. EDT",10341,9270,8484,-1857
ISNE,"4/14/2018 6 a.m. EDT",10687,9650,8741,-1946
ISNE,"4/14/2018 7 a.m. EDT",11251,10230,9215,-2036
ISNE,"4/14/2018 8 a.m. EDT",11431,10800,9413,-2018
ISNE,"4/14/2018 9 a.m. EDT",11194,11160,9404,-1790
ISNE,"4/14/2018 10 a.m. EDT",11167,11280,9544,-1623
ISNE,"4/14/2018 11 a.m. EDT",11084,11360,9609,-1475
ISNE,"4/14/2018 12 p.m. EDT",11066,11340,9519,-1547
ISNE,"4/14/2018 1 p.m. EDT",10977,11290,9693,-1284
ISNE,"4/14/2018 2 p.m. EDT",10862,11200,9598,-1264
ISNE,"4/14/2018 3 p.m. EDT",10869,11040,9494,-1375
ISNE,"4/14/2018 4 p.m. EDT",11101,11260,9830,-1271
ISNE,"4/14/2018 5 p.m. EDT",11570,11800,10196,-1374
ISNE,"4/14/2018 6 p.m. EDT",12175,12320,10691,-1484
ISNE,"4/14/2018 7 p.m. EDT",12583,12860,11041,-1542
ISNE,"4/14/2018 8 p.m. EDT",12907,12980,11115,-1792
ISNE,"4/14/2018 9 p.m. EDT",12836,13030,11249,-1587
ISNE,"4/14/2018 10 p.m. EDT",12303,12590,10578,-1725
ISNE,"4/14/2018 11 p.m. EDT",11570,11710,9837,-1733
ISNE,"4/15/2018 12 a.m. EDT",10824,10860,9154,-1670
ISNE,"4/15/2018 1 a.m. EDT",10537,10170,8674,-1863
ISNE,"4/15/2018 2 a.m. EDT",10333,9820,8512,-1821
ISNE,"4/15/2018 3 a.m. EDT",10181,9670,8336,-1845
ISNE,"4/15/2018 4 a.m. EDT",10120,9620,8228,-1892
ISNE,"4/15/2018 5 a.m. EDT",10187,9700,8305,-1882
ISNE,"4/15/2018 6 a.m. EDT",10121,10010,8242,-1879
ISNE,"4/15/2018 7 a.m. EDT",10465,10490,8684,-1781
ISNE,"4/15/2018 8 a.m. EDT",11182,11210,9529,-1653
ISNE,"4/15/2018 9 a.m. EDT",12066,12090,10521,-1545
ISNE,"4/15/2018 10 a.m. EDT",12846,12880,11180,-1666
ISNE,"4/15/2018 11 a.m. EDT",13337,13420,11369,-1968
ISNE,"4/15/2018 12 p.m. EDT",13575,13690,11546,-2029
ISNE,"4/15/2018 1 p.m. EDT",13672,13790,11845,-1827
ISNE,"4/15/2018 2 p.m. EDT",13638,13910,11681,-1957
ISNE,"4/15/2018 3 p.m. EDT",13587,13870,11604,-1983
ISNE,"4/15/2018 4 p.m. EDT",13653,13820,11694,-1959
ISNE,"4/15/2018 5 p.m. EDT",13962,14200,11893,-2069
ISNE,"4/15/2018 6 p.m. EDT",14333,14540,12110,-2223
ISNE,"4/15/2018 7 p.m. EDT",14501,14860,12252,-2249
ISNE,"4/15/2018 8 p.m. EDT",14643,14820,12569,-2074
ISNE,"4/15/2018 9 p.m. EDT",14346,14570,12613,-1733
ISNE,"4/15/2018 10 p.m. EDT",13555,13760,11813,-1742
ISNE,"4/15/2018 11 p.m. EDT",12571,12650,10515,-2056
ISNE,"4/16/2018 12 a.m. EDT",11687,11580,9784,-1903
ISNE,"4/16/2018 1 a.m. EDT",11265,10780,9270,-1995
ISNE,"4/16/2018 2 a.m. EDT",10988,10370,9252,-1736
ISNE,"4/16/2018 3 a.m. EDT",10828,10220,9109,-1719
ISNE,"4/16/2018 4 a.m. EDT",11107,10230,9167,-1940
ISNE,"4/16/2018 5 a.m. EDT",11253,10610,9693,-1560
ISNE,"4/16/2018 6 a.m. EDT",11769,11610,9999,-1770
ISNE,"4/16/2018 7 a.m. EDT",13082,12920,11335,-1747
ISNE,"4/16/2018 8 a.m. EDT",14162,14220,12393,-1769
ISNE,"4/16/2018 9 a.m. EDT",14834,14660,13154,-1680
ISNE,"4/16/2018 10 a.m. EDT",15256,15260,13436,-1820
ISNE,"4/16/2018 11 a.m. EDT",15477,15530,13465,-2012
ISNE,"4/16/2018 12 p.m. EDT",15529,15640,13605,-1924
ISNE,"4/16/2018 1 p.m. EDT",15424,15610,13666,-1758
ISNE,"4/16/2018 2 p.m. EDT",15329,15520,13498,-1831
ISNE,"4/16/2018 3 p.m. EDT",15093,15330,13129,-1964
ISNE,"4/16/2018 4 p.m. EDT",14913,15340,12953,-1960
ISNE,"4/16/2018 5 p.m. EDT",15099,15370,13020,-2079
ISNE,"4/16/2018 6 p.m. EDT",15052,15660,13013,-2039
ISNE,"4/16/2018 7 p.m. EDT",14878,15440,12890,-1988
ISNE,"4/16/2018 8 p.m. EDT",14865,15500,12875,-1990
ISNE,"4/16/2018 9 p.m. EDT",14579,15410,12877,-1702
ISNE,"4/16/2018 10 p.m. EDT",13806,14250,11932,-1874
ISNE,"4/16/2018 11 p.m. EDT",12667,12680,10487,-2180
ISNE,"4/17/2018 12 a.m. EDT",11848,11280,9676,-2172
ISNE,"4/17/2018 1 a.m. EDT",11153,10570,9217,-1936
ISNE,"4/17/2018 2 a.m. EDT",10788,10180,8692,-2096
ISNE,"4/17/2018 3 a.m. EDT",10716,10000,8579,-2137
ISNE,"4/17/2018 4 a.m. EDT",10767,10000,8716,-2051
ISNE,"4/17/2018 5 a.m. EDT",11116,10350,9081,-2035
ISNE,"4/17/2018 6 a.m. EDT",11536,11290,9498,-2038
ISNE,"4/17/2018 7 a.m. EDT",12580,12650,10699,-1881
ISNE,"4/17/2018 8 a.m. EDT",13398,13480,11441,-1957
ISNE,"4/17/2018 9 a.m. EDT",13456,13250,11487,-1969
ISNE,"4/17/2018 10 a.m. EDT",13345,13000,11213,-2132
ISNE,"4/17/2018 11 a.m. EDT",13461,12890,11437,-2024
ISNE,"4/17/2018 12 p.m. EDT",13397,13020,11448,-1949
ISNE,"4/17/2018 1 p.m. EDT",13189,12960,11333,-1856
ISNE,"4/17/2018 2 p.m. EDT",13481,13080,11819,-1662
ISNE,"4/17/2018 3 p.m. EDT",13331,13000,11636,-1695
ISNE,"4/17/2018 4 p.m. EDT",13721,13110,11855,-1866
ISNE,"4/17/2018 5 p.m. EDT",14221,13440,12384,-1837
ISNE,"4/17/2018 6 p.m. EDT",14237,13830,12342,-1895
ISNE,"4/17/2018 7 p.m. EDT",14295,14130,12370,-1925
ISNE,"4/17/2018 8 p.m. EDT",14583,14410,12632,-1951
ISNE,"4/17/2018 9 p.m. EDT",14470,14460,12775,-1695
ISNE,"4/17/2018 10 p.m. EDT",13671,13550,11805,-1866
ISNE,"4/17/2018 11 p.m. EDT",12883,12310,10879,-2004
ISNE,"4/18/2018 12 a.m. EDT",12044,11200,10015,-2029
ISNE,"4/18/2018 1 a.m. EDT",11489,10830,9281,-2208
ISNE,"4/18/2018 2 a.m. EDT",11321,10450,9053,-2268
ISNE,"4/18/2018 3 a.m. EDT",11272,10330,9012,-2260
ISNE,"4/18/2018 4 a.m. EDT",11208,10350,8997,-2211
ISNE,"4/18/2018 5 a.m. EDT",11164,10720,9033,-2131
ISNE,"4/18/2018 6 a.m. EDT",11699,11610,9629,-2070
ISNE,"4/18/2018 7 a.m. EDT",12996,12890,10881,-2115
ISNE,"4/18/2018 8 a.m. EDT",13764,13710,11593,-2171
ISNE,"4/18/2018 9 a.m. EDT",13754,13470,11517,-2237
ISNE,"4/18/2018 10 a.m. EDT",13511,13080,11313,-2198
ISNE,"4/18/2018 11 a.m. EDT",13247,12810,11131,-2116
ISNE,"4/18/2018 12 p.m. EDT",12940,12480,10829,-2111
ISNE,"4/18/2018 1 p.m. EDT",12614,12580,10384,-2230
ISNE,"4/18/2018 2 p.m. EDT",12884,12500,10690,-2194
ISNE,"4/18/2018 3 p.m. EDT",12956,12410,10746,-2210
ISNE,"4/18/2018 4 p.m. EDT",12961,12610,10876,-2085
ISNE,"4/18/2018 5 p.m. EDT",12932,12880,10678,-2254
ISNE,"4/18/2018 6 p.m. EDT",13266,13420,11145,-2121
ISNE,"4/18/2018 7 p.m. EDT",13734,13510,11609,-2125
ISNE,"4/18/2018 8 p.m. EDT",14164,14020,11872,-2292
ISNE,"4/18/2018 9 p.m. EDT",14199,14130,12010,-2189
ISNE,"4/18/2018 10 p.m. EDT",13421,13350,11264,-2157
ISNE,"4/18/2018 11 p.m. EDT",12296,12140,10178,-2118
ISNE,"4/19/2018 12 a.m. EDT",11482,11040,9131,-2351
ISNE,"4/19/2018 1 a.m. EDT",10706,10550,8569,-2137
ISNE,"4/19/2018 2 a.m. EDT",10468,10170,8344,-2124
ISNE,"4/19/2018 3 a.m. EDT",10380,10010,8197,-2183
ISNE,"4/19/2018 4 a.m. EDT",10531,10000,8239,-2292
ISNE,"4/19/2018 5 a.m. EDT",10627,10290,8365,-2262
ISNE,"4/19/2018 6 a.m. EDT",11465,11310,9328,-2137
ISNE,"4/19/2018 7 a.m. EDT",12671,12920,10432,-2239
ISNE,"4/19/2018 8 a.m. EDT",13837,13900,11591,-2246
ISNE,"4/19/2018 9 a.m. EDT",14393,14080,12195,-2198
ISNE,"4/19/2018 10 a.m. EDT",14612,14540,12556,-2056
ISNE,"4/19/2018 11 a.m. EDT",14684,14570,12455,-2229
ISNE,"4/19/2018 12 p.m. EDT",14466,14560,12306,-2160
ISNE,"4/19/2018 1 p.m. EDT",14218,14530,12024,-2194
ISNE,"4/19/2018 2 p.m. EDT",14286,14410,11966,-2320
ISNE,"4/19/2018 3 p.m. EDT",14257,14330,11963,-2294
ISNE,"4/19/2018 4 p.m. EDT",13977,14310,11702,-2275
ISNE,"4/19/2018 5 p.m. EDT",13828,14480,11631,-2197
ISNE,"4/19/2018 6 p.m. EDT",13923,14790,11666,-2257
ISNE,"4/19/2018 7 p.m. EDT",14255,14960,12016,-2239
ISNE,"4/19/2018 8 p.m. EDT",14588,15150,12406,-2182
ISNE,"4/19/2018 9 p.m. EDT",14546,14700,12514,-2032
ISNE,"4/19/2018 10 p.m. EDT",13793,13790,11598,-2195
ISNE,"4/19/2018 11 p.m. EDT",12675,12570,10607,-2068
ISNE,"4/20/2018 12 a.m. EDT",11899,11470,9661,-2238
ISNE,"4/20/2018 1 a.m. EDT",11000,10930,9000,-2000
ISNE,"4/20/2018 2 a.m. EDT",10580,10570,8498,-2082
ISNE,"4/20/2018 3 a.m. EDT",10686,10400,8567,-2119
ISNE,"4/20/2018 4 a.m. EDT",10691,10410,8505,-2186
ISNE,"4/20/2018 5 a.m. EDT",11017,10770,8778,-2239
ISNE,"4/20/2018 6 a.m. EDT",11662,11610,9631,-2031
ISNE,"4/20/2018 7 a.m. EDT",12920,12870,11274,-1646
ISNE,"4/20/2018 8 a.m. EDT",13595,13540,12122,-1473
ISNE,"4/20/2018 9 a.m. EDT",13446,13330,11774,-1672
ISNE,"4/20/2018 10 a.m. EDT",13096,13130,11194,-1902
ISNE,"4/20/2018 11 a.m. EDT",12998,12530,11192,-1806
ISNE,"4/20/2018 12 p.m. EDT",12601,12330,10801,-1800
ISNE,"4/20/2018 1 p.m. EDT",12621,12210,10724,-1897
ISNE,"4/20/2018 2 p.m. EDT",12295,12140,10336,-1959
ISNE,"4/20/2018 3 p.m. EDT",12007,12070,10037,-1970
ISNE,"4/20/2018 4 p.m. EDT",12112,12320,10118,-1994
ISNE,"4/20/2018 5 p.m. EDT",12547,12560,10501,-2046
ISNE,"4/20/2018 6 p.m. EDT",12790,12840,10693,-2097
ISNE,"4/20/2018 7 p.m. EDT",13162,13040,11032,-2130
ISNE,"4/20/2018 8 p.m. EDT",13564,13470,11477,-2087
ISNE,"4/20/2018 9 p.m. EDT",13729,13710,11693,-2036
ISNE,"4/20/2018 10 p.m. EDT",13157,13080,10940,-2217
ISNE,"4/20/2018 11 p.m. EDT",12273,12170,10071,-2202
ISNE,"4/21/2018 12 a.m. EDT",11332,11150,9162,-2170
ISNE,"4/21/2018 1 a.m. EDT",10645,10670,8468,-2177
ISNE,"4/21/2018 2 a.m. EDT",10417,10230,8338,-2079
ISNE,"4/21/2018 3 a.m. EDT",10331,10040,8218,-2113
ISNE,"4/21/2018 4 a.m. EDT",10293,9980,8172,-2121
ISNE,"4/21/2018 5 a.m. EDT",10418,10090,8452,-1966
ISNE,"4/21/2018 6 a.m. EDT",10583,10420,8615,-1968
ISNE,"4/21/2018 7 a.m. EDT",11073,10720,9211,-1862
ISNE,"4/21/2018 8 a.m. EDT",11415,11030,9714,-1701
ISNE,"4/21/2018 9 a.m. EDT",11410,11400,9788,-1622
ISNE,"4/21/2018 10 a.m. EDT",11213,11180,9702,-1511
ISNE,"4/21/2018 11 a.m. EDT",11545,10880,9958,-1587
ISNE,"4/21/2018 12 p.m. EDT",11421,10470,9764,-1657
ISNE,"4/21/2018 1 p.m. EDT",11127,10340,9729,-1398
ISNE,"4/21/2018 2 p.m. EDT",10943,10170,9581,-1362
ISNE,"4/21/2018 3 p.m. EDT",10921,10050,9458,-1463
ISNE,"4/21/2018 4 p.m. EDT",11213,10250,9592,-1621
ISNE,"4/21/2018 5 p.m. EDT",11471,10590,9768,-1703
ISNE,"4/21/2018 6 p.m. EDT",11843,11270,10024,-1819
ISNE,"4/21/2018 7 p.m. EDT",12081,11860,10324,-1757
ISNE,"4/21/2018 8 p.m. EDT",12310,12320,10471,-1839
ISNE,"4/21/2018 9 p.m. EDT",12583,12680,10753,-1830
ISNE,"4/21/2018 10 p.m. EDT",12114,12300,10250,-1864
ISNE,"4/21/2018 11 p.m. EDT",11620,11520,9867,-1753
ISNE,"4/22/2018 12 a.m. EDT",10844,10690,9087,-1757
ISNE,"4/22/2018 1 a.m. EDT",10345,10080,8804,-1541
ISNE,"4/22/2018 2 a.m. EDT",10139,9660,8455,-1684
ISNE,"4/22/2018 3 a.m. EDT",9975,9440,8322,-1653
ISNE,"4/22/2018 4 a.m. EDT",9932,9450,8292,-1640
ISNE,"4/22/2018 5 a.m. EDT",10032,9490,8345,-1687
ISNE,"4/22/2018 6 a.m. EDT",10097,9750,8468,-1629
ISNE,"4/22/2018 7 a.m. EDT",10208,10000,8621,-1587
ISNE,"4/22/2018 8 a.m. EDT",10396,10290,8870,-1526
ISNE,"4/22/2018 9 a.m. EDT",10390,10490,8808,-1582
ISNE,"4/22/2018 10 a.m. EDT",10258,10290,8787,-1471
ISNE,"4/22/2018 11 a.m. EDT",10087,10130,8863,-1224
ISNE,"4/22/2018 12 p.m. EDT",9935,9960,8777,-1158
ISNE,"4/22/2018 1 p.m. EDT",10065,9690,8855,-1210
ISNE,"4/22/2018 2 p.m. EDT",9921,9600,8719,-1202
ISNE,"4/22/2018 3 p.m. EDT",10063,9420,8942,-1121
ISNE,"4/22/2018 4 p.m. EDT",10088,9640,8942,-1146
ISNE,"4/22/2018 5 p.m. EDT",10605,10240,9435,-1170
ISNE,"4/22/2018 6 p.m. EDT",11306,11340,9836,-1470
ISNE,"4/22/2018 7 p.m. EDT",12013,11960,10196,-1817
ISNE,"4/22/2018 8 p.m. EDT",12559,12620,10804,-1755
ISNE,"4/22/2018 9 p.m. EDT",12912,12980,11340,-1572
ISNE,"4/22/2018 10 p.m. EDT",12195,12270,10555,-1640
ISNE,"4/22/2018 11 p.m. EDT",11138,11210,9417,-1721
ISNE,"4/23/2018 12 a.m. EDT",10459,10310,8605,-1854
ISNE,"4/23/2018 1 a.m. EDT",9709,9630,7890,-1819
ISNE,"4/23/2018 2 a.m. EDT",9427,9360,7673,-1754
ISNE,"4/23/2018 3 a.m. EDT",9540,9300,7626,-1914
ISNE,"4/23/2018 4 a.m. EDT",9401,9400,7659,-1742
ISNE,"4/23/2018 5 a.m. EDT",9837,9850,7986,-1851
ISNE,"4/23/2018 6 a.m. EDT",10915,10950,8991,-1924
ISNE,"4/23/2018 7 a.m. EDT",12473,12500,10506,-1967
ISNE,"4/23/2018 8 a.m. EDT",13060,13040,11212,-1848
ISNE,"4/23/2018 9 a.m. EDT",12574,12540,10747,-1827
ISNE,"4/23/2018 10 a.m. EDT",12064,12050,10305,-1759
ISNE,"4/23/2018 11 a.m. EDT",11757,11620,10227,-1530
ISNE,"4/23/2018 12 p.m. EDT",11567,11410,10111,-1456
ISNE,"4/23/2018 1 p.m. EDT",11385,11120,10049,-1336
ISNE,"4/23/2018 2 p.m. EDT",11316,10920,9877,-1439
ISNE,"4/23/2018 3 p.m. EDT",11214,10760,9733,-1481
ISNE,"4/23/2018 4 p.m. EDT",11295,10880,9763,-1532
ISNE,"4/23/2018 5 p.m. EDT",11705,11330,10041,-1664
ISNE,"4/23/2018 6 p.m. EDT",12385,12050,10699,-1686
ISNE,"4/23/2018 7 p.m. EDT",12968,12580,11141,-1827
ISNE,"4/23/2018 8 p.m. EDT",13404,13400,11616,-1788
ISNE,"4/23/2018 9 p.m. EDT",13650,13500,11969,-1681
ISNE,"4/23/2018 10 p.m. EDT",12797,12670,10990,-1807
ISNE,"4/23/2018 11 p.m. EDT",11554,11410,9569,-1985
ISNE,"4/24/2018 12 a.m. EDT",10616,10390,8561,-2055
ISNE,"4/24/2018 1 a.m. EDT",10063,9790,7993,-2070
ISNE,"4/24/2018 2 a.m. EDT",9825,9450,7771,-2054
ISNE,"4/24/2018 3 a.m. EDT",9865,9350,7769,-2096
ISNE,"4/24/2018 4 a.m. EDT",9917,9410,7809,-2108
ISNE,"4/24/2018 5 a.m. EDT",10117,9790,8047,-2070
ISNE,"4/24/2018 6 a.m. EDT",10790,10820,8843,-1947
ISNE,"4/24/2018 7 a.m. EDT",12279,12310,10122,-2157
ISNE,"4/24/2018 8 a.m. EDT",12852,12850,10739,-2113
ISNE,"4/24/2018 9 a.m. EDT",12472,12440,10290,-2182
ISNE,"4/24/2018 10 a.m. EDT",11990,11980,9894,-2096
ISNE,"4/24/2018 11 a.m. EDT",11679,11790,9622,-2057
ISNE,"4/24/2018 12 p.m. EDT",11511,11630,9440,-2071
ISNE,"4/24/2018 1 p.m. EDT",11470,11660,9643,-1827
ISNE,"4/24/2018 2 p.m. EDT",11578,11740,10013,-1565
ISNE,"4/24/2018 3 p.m. EDT",11360,11720,9838,-1522
ISNE,"4/24/2018 4 p.m. EDT",11602,11850,10049,-1553
ISNE,"4/24/2018 5 p.m. EDT",12057,12150,10514,-1543
ISNE,"4/24/2018 6 p.m. EDT",12708,12560,11053,-1655
ISNE,"4/24/2018 7 p.m. EDT",13123,12930,11290,-1833
ISNE,"4/24/2018 8 p.m. EDT",13559,13380,11588,-1971
ISNE,"4/24/2018 9 p.m. EDT",13619,13650,11653,-1966
ISNE,"4/24/2018 10 p.m. EDT",12733,12810,10972,-1761
ISNE,"4/24/2018 11 p.m. EDT",11488,11550,9559,-1929
ISNE,"4/25/2018 12 a.m. EDT",10427,10420,8683,-1744
ISNE,"4/25/2018 1 a.m. EDT",10279,9680,8387,-1892
ISNE,"4/25/2018 2 a.m. EDT",10095,9290,8153,-1942
ISNE,"4/25/2018 3 a.m. EDT",9910,9110,7962,-1948
ISNE,"4/25/2018 4 a.m. EDT",9899,9100,8126,-1773
ISNE,"4/25/2018 5 a.m. EDT",10199,9410,8523,-1676
ISNE,"4/25/2018 6 a.m. EDT",10903,10350,9178,-1725
ISNE,"4/25/2018 7 a.m. EDT",12066,11900,10244,-1822
ISNE,"4/25/2018 8 a.m. EDT",13005,13010,11320,-1685
ISNE,"4/25/2018 9 a.m. EDT",13382,13380,11887,-1495
ISNE,"4/25/2018 10 a.m. EDT",13481,13500,12227,-1254
ISNE,"4/25/2018 11 a.m. EDT",13501,13540,12089,-1412
ISNE,"4/25/2018 12 p.m. EDT",13540,13470,12035,-1505
ISNE,"4/25/2018 1 p.m. EDT",13579,13410,11751,-1828
ISNE,"4/25/2018 2 p.m. EDT",13675,13380,11881,-1794
ISNE,"4/25/2018 3 p.m. EDT",13627,13280,11959,-1668
ISNE,"4/25/2018 4 p.m. EDT",13612,13380,11859,-1753
ISNE,"4/25/2018 5 p.m. EDT",13800,13510,12253,-1547
ISNE,"4/25/2018 6 p.m. EDT",14095,13720,12497,-1598
ISNE,"4/25/2018 7 p.m. EDT",14170,13790,12425,-1745
ISNE,"4/25/2018 8 p.m. EDT",14193,14000,12268,-1925
ISNE,"4/25/2018 9 p.m. EDT",13908,13800,12084,-1824
ISNE,"4/25/2018 10 p.m. EDT",13009,12880,11399,-1610
ISNE,"4/25/2018 11 p.m. EDT",11969,11630,10183,-1786
ISNE,"4/26/2018 12 a.m. EDT",10945,10510,9067,-1878
ISNE,"4/26/2018 1 a.m. EDT",10206,9850,7960,-2246
ISNE,"4/26/2018 2 a.m. EDT",9757,9460,7818,-1939
ISNE,"4/26/2018 3 a.m. EDT",9707,9290,7794,-1913
ISNE,"4/26/2018 4 a.m. EDT",9676,9280,7584,-2092
ISNE,"4/26/2018 5 a.m. EDT",9821,9520,7546,-2275
ISNE,"4/26/2018 6 a.m. EDT",10428,10420,8266,-2162
ISNE,"4/26/2018 7 a.m. EDT",12011,12020,9891,-2120
ISNE,"4/26/2018 8 a.m. EDT",13099,12980,10953,-2146
ISNE,"4/26/2018 9 a.m. EDT",13362,13320,11292,-2070
ISNE,"4/26/2018 10 a.m. EDT",13223,13200,11101,-2122
ISNE,"4/26/2018 11 a.m. EDT",12913,12940,10767,-2146
ISNE,"4/26/2018 12 p.m. EDT",12598,12720,10438,-2160
ISNE,"4/26/2018 1 p.m. EDT",12342,12340,10190,-2152
ISNE,"4/26/2018 2 p.m. EDT",12478,12230,10371,-2107
ISNE,"4/26/2018 3 p.m. EDT",12653,12140,10644,-2009
ISNE,"4/26/2018 4 p.m. EDT",12558,12330,10549,-2009
ISNE,"4/26/2018 5 p.m. EDT",12533,12560,10584,-1949
ISNE,"4/26/2018 6 p.m. EDT",12687,12830,10819,-1868
ISNE,"4/26/2018 7 p.m. EDT",13026,13070,11045,-1981
ISNE,"4/26/2018 8 p.m. EDT",13305,13480,11348,-1957
ISNE,"4/26/2018 9 p.m. EDT",13537,13670,12040,-1497
ISNE,"4/26/2018 10 p.m. EDT",12811,12870,11338,-1473
ISNE,"4/26/2018 11 p.m. EDT",11620,11680,9919,-1701
ISNE,"4/27/2018 12 a.m. EDT",10679,10550,8785,-1894
ISNE,"4/27/2018 1 a.m. EDT",10285,9830,8372,-1913
ISNE,"4/27/2018 2 a.m. EDT",9907,9440,8164,-1743
ISNE,"4/27/2018 3 a.m. EDT",9965,9250,8220,-1745
ISNE,"4/27/2018 4 a.m. EDT",9835,9230,8395,-1440
ISNE,"4/27/2018 5 a.m. EDT",9882,9540,8275,-1607
ISNE,"4/27/2018 6 a.m. EDT",10335,10410,9034,-1301
ISNE,"4/27/2018 7 a.m. EDT",11715,11800,10093,-1622
ISNE,"4/27/2018 8 a.m. EDT",12427,12740,10931,-1496
ISNE,"4/27/2018 9 a.m. EDT",12353,12740,11187,-1166
ISNE,"4/27/2018 10 a.m. EDT",12252,12230,10901,-1351
ISNE,"4/27/2018 11 a.m. EDT",12684,12420,11338,-1346
ISNE,"4/27/2018 12 p.m. EDT",13131,12550,11794,-1337
ISNE,"4/27/2018 1 p.m. EDT",13199,12700,11859,-1340
ISNE,"4/27/2018 2 p.m. EDT",13305,12810,11969,-1336
ISNE,"4/27/2018 3 p.m. EDT",13221,12720,11910,-1311
ISNE,"4/27/2018 4 p.m. EDT",13225,12810,11835,-1390
ISNE,"4/27/2018 5 p.m. EDT",13286,12900,11584,-1702
ISNE,"4/27/2018 6 p.m. EDT",13394,12960,11616,-1778
ISNE,"4/27/2018 7 p.m. EDT",13420,13010,11743,-1677
ISNE,"4/27/2018 8 p.m. EDT",13416,13190,11381,-2035
ISNE,"4/27/2018 9 p.m. EDT",13244,13170,11103,-2141
ISNE,"4/27/2018 10 p.m. EDT",12554,12490,10516,-2038
ISNE,"4/27/2018 11 p.m. EDT",11578,11500,9330,-2248
ISNE,"4/28/2018 12 a.m. EDT",10585,10500,8276,-2309
ISNE,"4/28/2018 1 a.m. EDT",10105,9850,7646,-2459
ISNE,"4/28/2018 2 a.m. EDT",9645,9420,7259,-2386
ISNE,"4/28/2018 3 a.m. EDT",9584,9210,7213,-2371
ISNE,"4/28/2018 4 a.m. EDT",9573,9100,7143,-2430
ISNE,"4/28/2018 5 a.m. EDT",9674,9190,7373,-2301
ISNE,"4/28/2018 6 a.m. EDT",9773,9520,7367,-2406
ISNE,"4/28/2018 7 a.m. EDT",10311,10020,7877,-2434
ISNE,"4/28/2018 8 a.m. EDT",10639,10720,8542,-2097
ISNE,"4/28/2018 9 a.m. EDT",11064,11160,8848,-2216
ISNE,"4/28/2018 10 a.m. EDT",11067,11070,8862,-2205
ISNE,"4/28/2018 11 a.m. EDT",10774,10930,8819,-1955
ISNE,"4/28/2018 12 p.m. EDT",10497,10670,8422,-2075
ISNE,"4/28/2018 1 p.m. EDT",10282,10450,8175,-2107
ISNE,"4/28/2018 2 p.m. EDT",10195,10290,8155,-2040
ISNE,"4/28/2018 3 p.m. EDT",10184,10220,8289,-1895
ISNE,"4/28/2018 4 p.m. EDT",10177,10430,8270,-1907
ISNE,"4/28/2018 5 p.m. EDT",10655,10890,8643,-2012
ISNE,"4/28/2018 6 p.m. EDT",11302,11420,9170,-2132
ISNE,"4/28/2018 7 p.m. EDT",11705,11810,9600,-2105
ISNE,"4/28/2018 8 p.m. EDT",11962,12210,9773,-2189
ISNE,"4/28/2018 9 p.m. EDT",12255,12430,10038,-2217
ISNE,"4/28/2018 10 p.m. EDT",11730,12030,9629,-2101
ISNE,"4/28/2018 11 p.m. EDT",10925,11220,8761,-2164
ISNE,"4/29/2018 12 a.m. EDT",10216,10320,8181,-2035
ISNE,"4/29/2018 1 a.m. EDT",10077,9550,8040,-2037
ISNE,"4/29/2018 2 a.m. EDT",9760,9100,8081,-1679
ISNE,"4/29/2018 3 a.m. EDT",9779,8820,8076,-1703
ISNE,"4/29/2018 4 a.m. EDT",9910,8800,7899,-2011
ISNE,"4/29/2018 5 a.m. EDT",9971,8840,7847,-2124
ISNE,"4/29/2018 6 a.m. EDT",10073,8970,7972,-2101
ISNE,"4/29/2018 7 a.m. EDT",10189,9320,8043,-2146
ISNE,"4/29/2018 8 a.m. EDT",10443,9940,8486,-1957
ISNE,"4/29/2018 9 a.m. EDT",10773,10580,8884,-1889
ISNE,"4/29/2018 10 a.m. EDT",11494,11530,9614,-1880
ISNE,"4/29/2018 11 a.m. EDT",11866,11710,10022,-1844
ISNE,"4/29/2018 12 p.m. EDT",11917,11720,10012,-1905
ISNE,"4/29/2018 1 p.m. EDT",11713,11700,9751,-1962
ISNE,"4/29/2018 2 p.m. EDT",11499,11510,9471,-2028
ISNE,"4/29/2018 3 p.m. EDT",11229,11450,9121,-2108
ISNE,"4/29/2018 4 p.m. EDT",11226,11400,9160,-2066
ISNE,"4/29/2018 5 p.m. EDT",11558,11680,9559,-1999
ISNE,"4/29/2018 6 p.m. EDT",12102,12250,10097,-2005
ISNE,"4/29/2018 7 p.m. EDT",12528,12590,10526,-2002
ISNE,"4/29/2018 8 p.m. EDT",12829,12810,10889,-1940
ISNE,"4/29/2018 9 p.m. EDT",12977,12900,11035,-1942
ISNE,"4/29/2018 10 p.m. EDT",12244,12270,10188,-2056
ISNE,"4/29/2018 11 p.m. EDT",11193,11270,9096,-2097
ISNE,"4/30/2018 12 a.m. EDT",10343,10300,8225,-2118
ISNE,"4/30/2018 1 a.m. EDT",10022,9590,8107,-1915
ISNE,"4/30/2018 2 a.m. EDT",9833,9270,8053,-1780
ISNE,"4/30/2018 3 a.m. EDT",9718,9160,7893,-1825
ISNE,"4/30/2018 4 a.m. EDT",9755,9210,7945,-1810
ISNE,"4/30/2018 5 a.m. EDT",10089,9580,8173,-1916
ISNE,"4/30/2018 6 a.m. EDT",11088,10630,9172,-1916
ISNE,"4/30/2018 7 a.m. EDT",12181,12140,10440,-1741
ISNE,"4/30/2018 8 a.m. EDT",13073,13180,11502,-1571
ISNE,"4/30/2018 9 a.m. EDT",13204,13370,11841,-1363
ISNE,"4/30/2018 10 a.m. EDT",13256,13280,11915,-1341
ISNE,"4/30/2018 11 a.m. EDT",13317,13410,11965,-1352
ISNE,"4/30/2018 12 p.m. EDT",13232,13410,12126,-1106
ISNE,"4/30/2018 1 p.m. EDT",13051,13370,11964,-1087
ISNE,"4/30/2018 2 p.m. EDT",13042,13270,11841,-1201
ISNE,"4/30/2018 3 p.m. EDT",13066,13350,11997,-1069
ISNE,"4/30/2018 4 p.m. EDT",13078,13350,11858,-1220
ISNE,"4/30/2018 5 p.m. EDT",13322,13430,11904,-1418
ISNE,"4/30/2018 6 p.m. EDT",13675,13760,12115,-1560
ISNE,"4/30/2018 7 p.m. EDT",13864,13940,12097,-1767
ISNE,"4/30/2018 8 p.m. EDT",14096,14180,12273,-1823
ISNE,"4/30/2018 9 p.m. EDT",14127,14140,12514,-1613
ISNE,"4/30/2018 10 p.m. EDT",13236,13270,11257,-1979
ISNE,"4/30/2018 11 p.m. EDT",11992,11870,9954,-2038
ISNE,"5/1/2018 12 a.m. EDT",10970,10830,8950,-2020
