"BA Code","Timestamp (Hour Ending)","Demand (MWh)","Demand Forecast (MWh)","Net Generation (MWh)","Total Interchange (MWh)"
ISNE,"11/1/2017 12 a.m. EDT",10595,10870,8053,-2542
ISNE,"11/1/2017 1 a.m. EDT",10173,9980,7805,-2368
ISNE,"11/1/2017 2 a.m. EDT",10242,9740,7712,-2530
ISNE,"11/1/2017 3 a.m. EDT",10444,9580,8098,-2346
ISNE,"11/1/2017 4 a.m. EDT",10293,9600,7960,-2333
ISNE,"11/1/2017 5 a.m. EDT",10230,9790,7999,-2231
ISNE,"11/1/2017 6 a.m. EDT",10917,10840,8792,-2125
ISNE,"11/1/2017 7 a.m. EDT",12438,12880,10774,-1664
ISNE,"11/1/2017 8 a.m. EDT",13589,13870,11679,-1910
ISNE,"11/1/2017 9 a.m. EDT",13738,13930,12022,-1716
ISNE,"11/1/2017 10 a.m. EDT",13715,13690,12070,-1645
ISNE,"11/1/2017 11 a.m. EDT",13762,13490,12293,-1469
ISNE,"11/1/2017 12 p.m. EDT",13857,13270,12418,-1439
ISNE,"11/1/2017 1 p.m. EDT",13731,13200,12375,-1356
ISNE,"11/1/2017 2 p.m. EDT",13657,13270,12146,-1511
ISNE,"11/1/2017 3 p.m. EDT",13535,13350,12249,-1286
ISNE,"11/1/2017 4 p.m. EDT",13634,13540,12175,-1459
ISNE,"11/1/2017 5 p.m. EDT",14017,14150,12479,-1538
ISNE,"11/1/2017 6 p.m. EDT",14763,15020,12972,-1791
ISNE,"11/1/2017 7 p.m. EDT",15271,15350,13580,-1691
ISNE,"11/1/2017 8 p.m. EDT",14944,14850,13332,-1612
ISNE,"11/1/2017 9 p.m. EDT",14312,14290,12567,-1745
ISNE,"11/1/2017 10 p.m. EDT",13312,13250,11311,-2001
ISNE,"11/1/2017 11 p.m. EDT",12199,11970,10313,-1886
ISNE,"11/2/2017 12 a.m. EDT",11210,10880,9174,-2036
ISNE,"11/2/2017 1 a.m. EDT",10770,10020,8847,-1923
ISNE,"11/2/2017 2 a.m. EDT",10499,9600,8769,-1730
ISNE,"11/2/2017 3 a.m. EDT",10249,9390,8403,-1846
ISNE,"11/2/2017 4 a.m. EDT",10320,9350,8402,-1918
ISNE,"11/2/2017 5 a.m. EDT",10846,9670,8994,-1852
ISNE,"11/2/2017 6 a.m. EDT",11649,10680,9890,-1759
ISNE,"11/2/2017 7 a.m. EDT",13036,12410,11507,-1529
ISNE,"11/2/2017 8 a.m. EDT",13672,13480,12382,-1290
ISNE,"11/2/2017 9 a.m. EDT",13766,13610,12545,-1221
ISNE,"11/2/2017 10 a.m. EDT",13820,13840,12439,-1381
ISNE,"11/2/2017 11 a.m. EDT",13951,13880,12835,-1116
ISNE,"11/2/2017 12 p.m. EDT",13975,13870,12809,-1166
ISNE,"11/2/2017 1 p.m. EDT",13855,13780,12796,-1059
ISNE,"11/2/2017 2 p.m. EDT",13680,13880,12463,-1217
ISNE,"11/2/2017 3 p.m. EDT",13700,13960,12576,-1124
ISNE,"11/2/2017 4 p.m. EDT",13786,14100,12836,-950
ISNE,"11/2/2017 5 p.m. EDT",14009,14700,12946,-1063
ISNE,"11/2/2017 6 p.m. EDT",14621,15390,13304,-1317
ISNE,"11/2/2017 7 p.m. EDT",15202,15480,14040,-1162
ISNE,"11/2/2017 8 p.m. EDT",14858,15040,13727,-1131
ISNE,"11/2/2017 9 p.m. EDT",14162,14250,13082,-1080
ISNE,"11/2/2017 10 p.m. EDT",13166,13180,11948,-1218
ISNE,"11/2/2017 11 p.m. EDT",11904,11890,10397,-1507
ISNE,"11/3/2017 12 a.m. EDT",11057,10830,9686,-1371
ISNE,"11/3/2017 1 a.m. EDT",10576,10060,9437,-1139
ISNE,"11/3/2017 2 a.m. EDT",10428,9580,9164,-1264
ISNE,"11/3/2017 3 a.m. EDT",10417,9340,8997,-1420
ISNE,"11/3/2017 4 a.m. EDT",10353,9270,8726,-1627
ISNE,"11/3/2017 5 a.m. EDT",10580,9510,8725,-1855
ISNE,"11/3/2017 6 a.m. EDT",11127,10390,9489,-1638
ISNE,"11/3/2017 7 a.m. EDT",12416,12140,11092,-1324
ISNE,"11/3/2017 8 a.m. EDT",13343,13320,12289,-1054
ISNE,"11/3/2017 9 a.m. EDT",13569,13590,12477,-1092
ISNE,"11/3/2017 10 a.m. EDT",13584,13730,12541,-1043
ISNE,"11/3/2017 11 a.m. EDT",13521,13800,12398,-1123
ISNE,"11/3/2017 12 p.m. EDT",13567,13760,12391,-1176
ISNE,"11/3/2017 1 p.m. EDT",13578,13730,12368,-1210
ISNE,"11/3/2017 2 p.m. EDT",13765,13770,12495,-1270
ISNE,"11/3/2017 3 p.m. EDT",13935,13870,12560,-1375
ISNE,"11/3/2017 4 p.m. EDT",13971,13990,12824,-1147
ISNE,"11/3/2017 5 p.m. EDT",14366,14190,13207,-1159
ISNE,"11/3/2017 6 p.m. EDT",14637,14630,13362,-1275
ISNE,"11/3/2017 7 p.m. EDT",14729,14980,13273,-1456
ISNE,"11/3/2017 8 p.m. EDT",14168,14440,12969,-1199
ISNE,"11/3/2017 9 p.m. EDT",13476,13490,12618,-858
ISNE,"11/3/2017 10 p.m. EDT",12629,12600,11689,-940
ISNE,"11/3/2017 11 p.m. EDT",11768,11570,10909,-859
ISNE,"11/4/2017 12 a.m. EDT",11131,10560,10168,-963
ISNE,"11/4/2017 1 a.m. EDT",10374,9810,9400,-974
ISNE,"11/4/2017 2 a.m. EDT",9912,9360,9045,-867
ISNE,"11/4/2017 3 a.m. EDT",9545,9110,8810,-735
ISNE,"11/4/2017 4 a.m. EDT",9533,9020,8764,-769
ISNE,"11/4/2017 5 a.m. EDT",9654,9150,8691,-963
ISNE,"11/4/2017 6 a.m. EDT",10025,9550,9025,-1000
ISNE,"11/4/2017 7 a.m. EDT",10562,10440,9618,-944
ISNE,"11/4/2017 8 a.m. EDT",11128,11290,10266,-862
ISNE,"11/4/2017 9 a.m. EDT",11759,11950,10874,-885
ISNE,"11/4/2017 10 a.m. EDT",11821,12220,10756,-1065
ISNE,"11/4/2017 11 a.m. EDT",11617,12200,10603,-1014
ISNE,"11/4/2017 12 p.m. EDT",11389,12000,10496,-893
ISNE,"11/4/2017 1 p.m. EDT",11180,11850,10309,-871
ISNE,"11/4/2017 2 p.m. EDT",11159,11760,10241,-918
ISNE,"11/4/2017 3 p.m. EDT",11259,11830,10339,-920
ISNE,"11/4/2017 4 p.m. EDT",11534,12180,10577,-957
ISNE,"11/4/2017 5 p.m. EDT",12099,13040,11158,-941
ISNE,"11/4/2017 6 p.m. EDT",13009,14040,12035,-974
ISNE,"11/4/2017 7 p.m. EDT",13593,14110,12541,-1052
ISNE,"11/4/2017 8 p.m. EDT",13246,13530,12215,-1031
ISNE,"11/4/2017 9 p.m. EDT",12806,12920,12140,-666
ISNE,"11/4/2017 10 p.m. EDT",12212,12190,11263,-949
ISNE,"11/4/2017 11 p.m. EDT",11398,11370,10172,-1226
ISNE,"11/5/2017 12 a.m. EDT",10571,10580,9211,-1360
ISNE,"11/5/2017 1 a.m. EDT",9870,9840,8368,-1502
ISNE,"11/5/2017 1 a.m. EST",9780,9390,8151,-1629
ISNE,"11/5/2017 2 a.m. EST",9846,9390,8269,-1577
ISNE,"11/5/2017 3 a.m. EST",9806,9020,8319,-1487
ISNE,"11/5/2017 4 a.m. EST",9788,9010,8705,-1083
ISNE,"11/5/2017 5 a.m. EST",9914,9170,8724,-1190
ISNE,"11/5/2017 6 a.m. EST",10177,9540,8983,-1194
ISNE,"11/5/2017 7 a.m. EST",10635,10070,9577,-1058
ISNE,"11/5/2017 8 a.m. EST",11113,10690,10065,-1048
ISNE,"11/5/2017 9 a.m. EST",11639,11250,10958,-681
ISNE,"11/5/2017 10 a.m. EST",12069,11640,11178,-891
ISNE,"11/5/2017 11 a.m. EST",12304,11870,11347,-957
ISNE,"11/5/2017 12 p.m. EST",12508,12050,11618,-890
ISNE,"11/5/2017 1 p.m. EST",12636,12260,11550,-1086
ISNE,"11/5/2017 2 p.m. EST",12726,12380,11662,-1064
ISNE,"11/5/2017 3 p.m. EST",12792,12550,11576,-1216
ISNE,"11/5/2017 4 p.m. EST",13037,12980,11883,-1154
ISNE,"11/5/2017 5 p.m. EST",13819,13930,12582,-1237
ISNE,"11/5/2017 6 p.m. EST",14548,14770,13408,-1140
ISNE,"11/5/2017 7 p.m. EST",14264,14520,12980,-1284
ISNE,"11/5/2017 8 p.m. EST",13715,13970,12528,-1187
ISNE,"11/5/2017 9 p.m. EST",12983,13280,11960,-1023
ISNE,"11/5/2017 10 p.m. EST",12034,12220,10909,-1125
ISNE,"11/5/2017 11 p.m. EST",10991,11160,9723,-1268
ISNE,"11/6/2017 12 a.m. EST",10244,10310,8992,-1252
ISNE,"11/6/2017 1 a.m. EST",10176,9590,9172,-1004
ISNE,"11/6/2017 2 a.m. EST",10129,9320,9148,-981
ISNE,"11/6/2017 3 a.m. EST",10333,9190,9262,-1071
ISNE,"11/6/2017 4 a.m. EST",10300,9230,9348,-952
ISNE,"11/6/2017 5 a.m. EST",10575,9550,9284,-1291
ISNE,"11/6/2017 6 a.m. EST",11308,10700,10066,-1242
ISNE,"11/6/2017 7 a.m. EST",12569,12430,11368,-1201
ISNE,"11/6/2017 8 a.m. EST",13461,13460,12357,-1104
ISNE,"11/6/2017 9 a.m. EST",13859,13740,12698,-1161
ISNE,"11/6/2017 10 a.m. EST",14102,13920,12943,-1159
ISNE,"11/6/2017 11 a.m. EST",14251,14150,13087,-1164
ISNE,"11/6/2017 12 p.m. EST",14279,14180,12900,-1379
ISNE,"11/6/2017 1 p.m. EST",14319,14020,12893,-1426
ISNE,"11/6/2017 2 p.m. EST",14399,14090,12861,-1538
ISNE,"11/6/2017 3 p.m. EST",14301,14140,12830,-1471
ISNE,"11/6/2017 4 p.m. EST",14334,14390,12909,-1425
ISNE,"11/6/2017 5 p.m. EST",15000,14990,13406,-1594
ISNE,"11/6/2017 6 p.m. EST",15650,15720,14115,-1535
ISNE,"11/6/2017 7 p.m. EST",15277,15580,13727,-1550
ISNE,"11/6/2017 8 p.m. EST",14624,15010,13243,-1381
ISNE,"11/6/2017 9 p.m. EST",13841,13990,12800,-1041
ISNE,"11/6/2017 10 p.m. EST",12795,12900,11707,-1088
ISNE,"11/6/2017 11 p.m. EST",11902,11730,10833,-1069
ISNE,"11/7/2017 12 a.m. EST",11540,10720,9897,-1643
ISNE,"11/7/2017 1 a.m. EST",10962,9890,9035,-1927
ISNE,"11/7/2017 2 a.m. EST",10851,9560,8771,-2080
ISNE,"11/7/2017 3 a.m. EST",10699,9400,8682,-2017
ISNE,"11/7/2017 4 a.m. EST",10707,9470,8833,-1874
ISNE,"11/7/2017 5 a.m. EST",10820,9860,9093,-1727
ISNE,"11/7/2017 6 a.m. EST",11654,11020,10137,-1517
ISNE,"11/7/2017 7 a.m. EST",12774,12970,11284,-1490
ISNE,"11/7/2017 8 a.m. EST",13276,13810,11429,-1847
ISNE,"11/7/2017 9 a.m. EST",13176,13630,11506,-1670
ISNE,"11/7/2017 10 a.m. EST",13033,13330,11757,-1276
ISNE,"11/7/2017 11 a.m. EST",13063,13070,11956,-1107
ISNE,"11/7/2017 12 p.m. EST",13388,12950,11988,-1400
ISNE,"11/7/2017 1 p.m. EST",13729,12920,12374,-1355
ISNE,"11/7/2017 2 p.m. EST",13962,13100,12401,-1561
ISNE,"11/7/2017 3 p.m. EST",14022,13350,12420,-1602
ISNE,"11/7/2017 4 p.m. EST",14238,13760,12443,-1795
ISNE,"11/7/2017 5 p.m. EST",15068,14820,12923,-2145
ISNE,"11/7/2017 6 p.m. EST",15797,15950,13615,-2182
ISNE,"11/7/2017 7 p.m. EST",15629,15830,13363,-2266
ISNE,"11/7/2017 8 p.m. EST",15160,15310,12916,-2244
ISNE,"11/7/2017 9 p.m. EST",14443,14580,12371,-2072
ISNE,"11/7/2017 10 p.m. EST",13437,13550,11463,-1974
ISNE,"11/7/2017 11 p.m. EST",12368,12270,10593,-1775
ISNE,"11/8/2017 12 a.m. EST",11931,11230,9968,-1963
ISNE,"11/8/2017 1 a.m. EST",11059,10500,8992,-2067
ISNE,"11/8/2017 2 a.m. EST",10976,10150,8822,-2154
ISNE,"11/8/2017 3 a.m. EST",11047,10000,8918,-2129
ISNE,"11/8/2017 4 a.m. EST",11006,10060,9252,-1754
ISNE,"11/8/2017 5 a.m. EST",11206,10470,9518,-1688
ISNE,"11/8/2017 6 a.m. EST",11785,11650,10390,-1395
ISNE,"11/8/2017 7 a.m. EST",13354,13470,11895,-1459
ISNE,"11/8/2017 8 a.m. EST",14180,14250,12267,-1913
ISNE,"11/8/2017 9 a.m. EST",14191,14130,11927,-2264
ISNE,"11/8/2017 10 a.m. EST",13871,13700,11686,-2185
ISNE,"11/8/2017 11 a.m. EST",13540,13340,11373,-2167
ISNE,"11/8/2017 12 p.m. EST",13262,13080,11136,-2126
ISNE,"11/8/2017 1 p.m. EST",13035,13000,10985,-2050
ISNE,"11/8/2017 2 p.m. EST",13120,12960,11151,-1969
ISNE,"11/8/2017 3 p.m. EST",13329,13190,11429,-1900
ISNE,"11/8/2017 4 p.m. EST",13862,13680,11812,-2050
ISNE,"11/8/2017 5 p.m. EST",14896,14770,12447,-2449
ISNE,"11/8/2017 6 p.m. EST",15980,15900,13452,-2528
ISNE,"11/8/2017 7 p.m. EST",15896,15890,13099,-2797
ISNE,"11/8/2017 8 p.m. EST",15515,15450,12625,-2890
ISNE,"11/8/2017 9 p.m. EST",14902,14820,12322,-2580
ISNE,"11/8/2017 10 p.m. EST",13956,13820,11583,-2373
ISNE,"11/8/2017 11 p.m. EST",12729,12600,10495,-2234
ISNE,"11/9/2017 12 a.m. EST",11687,11560,9717,-1970
ISNE,"11/9/2017 1 a.m. EST",11193,11030,9358,-1835
ISNE,"11/9/2017 2 a.m. EST",11711,10730,9603,-2108
ISNE,"11/9/2017 3 a.m. EST",11837,10580,9554,-2283
ISNE,"11/9/2017 4 a.m. EST",11955,10650,9735,-2220
ISNE,"11/9/2017 5 a.m. EST",12143,11040,9844,-2299
ISNE,"11/9/2017 6 a.m. EST",12811,12150,10793,-2018
ISNE,"11/9/2017 7 a.m. EST",13961,13970,11782,-2179
ISNE,"11/9/2017 8 a.m. EST",14574,14530,12086,-2488
ISNE,"11/9/2017 9 a.m. EST",14127,14200,11612,-2515
ISNE,"11/9/2017 10 a.m. EST",13506,13740,11329,-2177
ISNE,"11/9/2017 11 a.m. EST",13395,13390,11442,-1953
ISNE,"11/9/2017 12 p.m. EST",13363,13080,11446,-1917
ISNE,"11/9/2017 1 p.m. EST",13572,12920,11540,-2032
ISNE,"11/9/2017 2 p.m. EST",13796,13020,11551,-2245
ISNE,"11/9/2017 3 p.m. EST",13775,13320,11511,-2264
ISNE,"11/9/2017 4 p.m. EST",13954,13820,11757,-2197
ISNE,"11/9/2017 5 p.m. EST",14801,15010,12634,-2167
ISNE,"11/9/2017 6 p.m. EST",15736,16000,13804,-1932
ISNE,"11/9/2017 7 p.m. EST",15572,15690,13036,-2536
ISNE,"11/9/2017 8 p.m. EST",15106,15150,12571,-2535
ISNE,"11/9/2017 9 p.m. EST",14473,14460,12050,-2423
ISNE,"11/9/2017 10 p.m. EST",13631,13460,11243,-2388
ISNE,"11/9/2017 11 p.m. EST",12702,12260,10060,-2642
ISNE,"11/10/2017 12 a.m. EST",11846,11200,9371,-2475
ISNE,"11/10/2017 1 a.m. EST",11585,10540,9010,-2575
ISNE,"11/10/2017 2 a.m. EST",11432,10120,8788,-2644
ISNE,"11/10/2017 3 a.m. EST",11234,9910,8343,-2891
ISNE,"11/10/2017 4 a.m. EST",10966,9880,8304,-2662
ISNE,"11/10/2017 5 a.m. EST",11090,10200,8319,-2771
ISNE,"11/10/2017 6 a.m. EST",11198,11350,8681,-2517
ISNE,"11/10/2017 7 a.m. EST",12557,13170,9992,-2565
ISNE,"11/10/2017 8 a.m. EST",13454,14450,10536,-2918
ISNE,"11/10/2017 9 a.m. EST",13634,14310,11043,-2591
ISNE,"11/10/2017 10 a.m. EST",13510,14030,10917,-2593
ISNE,"11/10/2017 11 a.m. EST",13408,13700,10510,-2898
ISNE,"11/10/2017 12 p.m. EST",13330,13390,10497,-2833
ISNE,"11/10/2017 1 p.m. EST",13279,13350,10311,-2968
ISNE,"11/10/2017 2 p.m. EST",13490,13690,10314,-3176
ISNE,"11/10/2017 3 p.m. EST",14157,14050,11025,-3132
ISNE,"11/10/2017 4 p.m. EST",14691,14650,11484,-3207
ISNE,"11/10/2017 5 p.m. EST",15770,15770,12517,-3253
ISNE,"11/10/2017 6 p.m. EST",16671,17000,13309,-3362
ISNE,"11/10/2017 7 p.m. EST",16508,16940,13139,-3369
ISNE,"11/10/2017 8 p.m. EST",16118,16540,12729,-3389
ISNE,"11/10/2017 9 p.m. EST",15591,15960,12245,-3346
ISNE,"11/10/2017 10 p.m. EST",14839,15160,11481,-3358
ISNE,"11/10/2017 11 p.m. EST",13897,14140,10611,-3286
ISNE,"11/11/2017 12 a.m. EST",13386,13210,10078,-3308
ISNE,"11/11/2017 1 a.m. EST",12605,12290,9258,-3347
ISNE,"11/11/2017 2 a.m. EST",11928,11910,8694,-3234
ISNE,"11/11/2017 3 a.m. EST",11701,11680,8592,-3109
ISNE,"11/11/2017 4 a.m. EST",11648,11630,8411,-3237
ISNE,"11/11/2017 5 a.m. EST",11969,11790,8653,-3316
ISNE,"11/11/2017 6 a.m. EST",12295,12270,9025,-3270
ISNE,"11/11/2017 7 a.m. EST",12970,12960,9606,-3364
ISNE,"11/11/2017 8 a.m. EST",13559,13550,10189,-3370
ISNE,"11/11/2017 9 a.m. EST",13756,13740,10271,-3485
ISNE,"11/11/2017 10 a.m. EST",13617,13650,9959,-3658
ISNE,"11/11/2017 11 a.m. EST",13596,13350,9749,-3847
ISNE,"11/11/2017 12 p.m. EST",13348,13120,9471,-3877
ISNE,"11/11/2017 1 p.m. EST",13117,12760,9303,-3814
ISNE,"11/11/2017 2 p.m. EST",13252,12570,9342,-3910
ISNE,"11/11/2017 3 p.m. EST",13409,12590,9481,-3928
ISNE,"11/11/2017 4 p.m. EST",13733,13230,10085,-3648
ISNE,"11/11/2017 5 p.m. EST",14877,14520,11306,-3571
ISNE,"11/11/2017 6 p.m. EST",15830,15800,12468,-3362
ISNE,"11/11/2017 7 p.m. EST",15639,15650,12135,-3504
ISNE,"11/11/2017 8 p.m. EST",15232,15110,11594,-3638
ISNE,"11/11/2017 9 p.m. EST",14767,14500,10754,-4013
ISNE,"11/11/2017 10 p.m. EST",14135,13810,10408,-3727
ISNE,"11/11/2017 11 p.m. EST",13307,13050,9832,-3475
ISNE,"11/12/2017 12 a.m. EST",12704,12300,9137,-3567
ISNE,"11/12/2017 1 a.m. EST",12090,11820,8617,-3473
ISNE,"11/12/2017 2 a.m. EST",11819,11450,8312,-3507
ISNE,"11/12/2017 3 a.m. EST",11788,11230,8213,-3575
ISNE,"11/12/2017 4 a.m. EST",11695,11160,8205,-3490
ISNE,"11/12/2017 5 a.m. EST",11550,11270,8059,-3491
ISNE,"11/12/2017 6 a.m. EST",11845,11580,8418,-3427
ISNE,"11/12/2017 7 a.m. EST",12316,12100,8993,-3323
ISNE,"11/12/2017 8 a.m. EST",12685,12690,9382,-3303
ISNE,"11/12/2017 9 a.m. EST",13282,13290,9926,-3356
ISNE,"11/12/2017 10 a.m. EST",13273,13330,9918,-3355
ISNE,"11/12/2017 11 a.m. EST",12953,13320,9589,-3364
ISNE,"11/12/2017 12 p.m. EST",12706,13320,9329,-3377
ISNE,"11/12/2017 1 p.m. EST",12639,13260,9050,-3589
ISNE,"11/12/2017 2 p.m. EST",12845,13190,9398,-3447
ISNE,"11/12/2017 3 p.m. EST",13524,13240,9922,-3602
ISNE,"11/12/2017 4 p.m. EST",13633,13610,10183,-3450
ISNE,"11/12/2017 5 p.m. EST",14622,14700,11166,-3456
ISNE,"11/12/2017 6 p.m. EST",15698,16040,12036,-3662
ISNE,"11/12/2017 7 p.m. EST",15609,16010,11919,-3690
ISNE,"11/12/2017 8 p.m. EST",15191,15660,11554,-3637
ISNE,"11/12/2017 9 p.m. EST",14597,14980,10967,-3630
ISNE,"11/12/2017 10 p.m. EST",13704,14000,10167,-3537
ISNE,"11/12/2017 11 p.m. EST",12707,12900,9209,-3498
ISNE,"11/13/2017 12 a.m. EST",12022,11900,8496,-3526
ISNE,"11/13/2017 1 a.m. EST",11553,11280,8299,-3254
ISNE,"11/13/2017 2 a.m. EST",11636,10930,8347,-3289
ISNE,"11/13/2017 3 a.m. EST",11719,10760,8480,-3239
ISNE,"11/13/2017 4 a.m. EST",11777,10780,8512,-3265
ISNE,"11/13/2017 5 a.m. EST",11889,11140,8760,-3129
ISNE,"11/13/2017 6 a.m. EST",12434,12250,9438,-2996
ISNE,"11/13/2017 7 a.m. EST",13938,14090,10892,-3046
ISNE,"11/13/2017 8 a.m. EST",14904,15090,11854,-3050
ISNE,"11/13/2017 9 a.m. EST",15143,15060,12003,-3140
ISNE,"11/13/2017 10 a.m. EST",15273,14900,12154,-3119
ISNE,"11/13/2017 11 a.m. EST",15424,14790,12140,-3284
ISNE,"11/13/2017 12 p.m. EST",15511,14660,12060,-3451
ISNE,"11/13/2017 1 p.m. EST",15509,14560,11992,-3517
ISNE,"11/13/2017 2 p.m. EST",15484,14600,12007,-3477
ISNE,"11/13/2017 3 p.m. EST",15361,14600,11875,-3486
ISNE,"11/13/2017 4 p.m. EST",15540,14920,12103,-3437
ISNE,"11/13/2017 5 p.m. EST",16264,15850,12988,-3276
ISNE,"11/13/2017 6 p.m. EST",16926,16880,13653,-3273
ISNE,"11/13/2017 7 p.m. EST",16740,16780,13381,-3359
ISNE,"11/13/2017 8 p.m. EST",16252,16390,12899,-3353
ISNE,"11/13/2017 9 p.m. EST",15526,15630,12108,-3418
ISNE,"11/13/2017 10 p.m. EST",14419,14530,10886,-3533
ISNE,"11/13/2017 11 p.m. EST",13101,13280,9562,-3539
ISNE,"11/14/2017 12 a.m. EST",12228,12200,8680,-3548
ISNE,"11/14/2017 1 a.m. EST",12217,11280,8719,-3498
ISNE,"11/14/2017 2 a.m. EST",12225,10890,8737,-3488
ISNE,"11/14/2017 3 a.m. EST",12028,10710,8569,-3459
ISNE,"11/14/2017 4 a.m. EST",12017,10720,8524,-3493
ISNE,"11/14/2017 5 a.m. EST",12356,11070,8811,-3545
ISNE,"11/14/2017 6 a.m. EST",12913,12170,9571,-3342
ISNE,"11/14/2017 7 a.m. EST",14023,13930,10680,-3343
ISNE,"11/14/2017 8 a.m. EST",14816,15090,11456,-3360
ISNE,"11/14/2017 9 a.m. EST",15000,15130,11597,-3403
ISNE,"11/14/2017 10 a.m. EST",15007,15020,11613,-3394
ISNE,"11/14/2017 11 a.m. EST",15028,14860,11612,-3416
ISNE,"11/14/2017 12 p.m. EST",15036,14650,11654,-3382
ISNE,"11/14/2017 1 p.m. EST",14964,14390,11516,-3448
ISNE,"11/14/2017 2 p.m. EST",14976,14380,11365,-3611
ISNE,"11/14/2017 3 p.m. EST",14962,14640,11448,-3514
ISNE,"11/14/2017 4 p.m. EST",15153,14950,11744,-3409
ISNE,"11/14/2017 5 p.m. EST",16014,15890,12479,-3535
ISNE,"11/14/2017 6 p.m. EST",16652,16830,13220,-3432
ISNE,"11/14/2017 7 p.m. EST",16495,16650,13030,-3465
ISNE,"11/14/2017 8 p.m. EST",16051,16170,12503,-3548
ISNE,"11/14/2017 9 p.m. EST",15363,15370,11757,-3606
ISNE,"11/14/2017 10 p.m. EST",14325,14260,10775,-3550
ISNE,"11/14/2017 11 p.m. EST",13088,13010,9524,-3564
ISNE,"11/15/2017 12 a.m. EST",12396,11940,8881,-3515
ISNE,"11/15/2017 1 a.m. EST",11773,11300,8699,-3074
ISNE,"11/15/2017 2 a.m. EST",11687,10970,8507,-3180
ISNE,"11/15/2017 3 a.m. EST",11563,10790,8301,-3262
ISNE,"11/15/2017 4 a.m. EST",11846,10800,8531,-3315
ISNE,"11/15/2017 5 a.m. EST",11953,11200,8704,-3249
ISNE,"11/15/2017 6 a.m. EST",12575,12300,9543,-3032
ISNE,"11/15/2017 7 a.m. EST",14102,14160,11102,-3000
ISNE,"11/15/2017 8 a.m. EST",14841,14960,11840,-3001
ISNE,"11/15/2017 9 a.m. EST",14422,14480,11321,-3101
ISNE,"11/15/2017 10 a.m. EST",13843,14040,11015,-2828
ISNE,"11/15/2017 11 a.m. EST",13534,13620,11048,-2486
ISNE,"11/15/2017 12 p.m. EST",13442,13330,11029,-2413
ISNE,"11/15/2017 1 p.m. EST",13439,13200,10991,-2448
ISNE,"11/15/2017 2 p.m. EST",13778,13360,11310,-2468
ISNE,"11/15/2017 3 p.m. EST",13962,13630,11489,-2473
ISNE,"11/15/2017 4 p.m. EST",14374,14190,11595,-2779
ISNE,"11/15/2017 5 p.m. EST",15462,15330,12511,-2951
ISNE,"11/15/2017 6 p.m. EST",16414,16430,13498,-2916
ISNE,"11/15/2017 7 p.m. EST",16326,16290,13129,-3197
ISNE,"11/15/2017 8 p.m. EST",15906,15820,12672,-3234
ISNE,"11/15/2017 9 p.m. EST",15305,15080,12310,-2995
ISNE,"11/15/2017 10 p.m. EST",14422,14030,11392,-3030
ISNE,"11/15/2017 11 p.m. EST",13430,12780,10319,-3111
ISNE,"11/16/2017 12 a.m. EST",12719,11710,9384,-3335
ISNE,"11/16/2017 1 a.m. EST",12288,11090,9033,-3255
ISNE,"11/16/2017 2 a.m. EST",11878,10650,8883,-2995
ISNE,"11/16/2017 3 a.m. EST",11828,10450,8787,-3041
ISNE,"11/16/2017 4 a.m. EST",11865,10460,8839,-3026
ISNE,"11/16/2017 5 a.m. EST",11914,10770,9033,-2881
ISNE,"11/16/2017 6 a.m. EST",12795,11840,9915,-2880
ISNE,"11/16/2017 7 a.m. EST",14132,13620,11240,-2892
ISNE,"11/16/2017 8 a.m. EST",14629,14570,11747,-2882
ISNE,"11/16/2017 9 a.m. EST",14887,14830,12218,-2669
ISNE,"11/16/2017 10 a.m. EST",14916,14860,12097,-2819
ISNE,"11/16/2017 11 a.m. EST",14888,14880,11874,-3014
ISNE,"11/16/2017 12 p.m. EST",14881,14810,11824,-3057
ISNE,"11/16/2017 1 p.m. EST",14833,14800,11622,-3211
ISNE,"11/16/2017 2 p.m. EST",14793,14660,11595,-3198
ISNE,"11/16/2017 3 p.m. EST",14723,14730,11538,-3185
ISNE,"11/16/2017 4 p.m. EST",14845,14980,11812,-3033
ISNE,"11/16/2017 5 p.m. EST",15540,15770,12352,-3188
ISNE,"11/16/2017 6 p.m. EST",16169,16370,13032,-3137
ISNE,"11/16/2017 7 p.m. EST",15968,16160,12719,-3249
ISNE,"11/16/2017 8 p.m. EST",15519,15670,12267,-3252
ISNE,"11/16/2017 9 p.m. EST",14906,15030,11820,-3086
ISNE,"11/16/2017 10 p.m. EST",13956,14040,10908,-3048
ISNE,"11/16/2017 11 p.m. EST",12761,12830,9439,-3322
ISNE,"11/17/2017 12 a.m. EST",11922,11740,8704,-3218
ISNE,"11/17/2017 1 a.m. EST",11786,10980,8655,-3131
ISNE,"11/17/2017 2 a.m. EST",11688,10590,8445,-3243
ISNE,"11/17/2017 3 a.m. EST",11700,10460,8417,-3283
ISNE,"11/17/2017 4 a.m. EST",11817,10480,8507,-3310
ISNE,"11/17/2017 5 a.m. EST",12163,10850,8882,-3281
ISNE,"11/17/2017 6 a.m. EST",12606,11920,9698,-2908
ISNE,"11/17/2017 7 a.m. EST",13703,13700,10596,-3107
ISNE,"11/17/2017 8 a.m. EST",14609,14210,11487,-3122
ISNE,"11/17/2017 9 a.m. EST",14699,14180,11578,-3121
ISNE,"11/17/2017 10 a.m. EST",14297,14250,11352,-2945
ISNE,"11/17/2017 11 a.m. EST",13885,13670,10956,-2929
ISNE,"11/17/2017 12 p.m. EST",13595,13420,10697,-2898
ISNE,"11/17/2017 1 p.m. EST",13362,13290,10545,-2817
ISNE,"11/17/2017 2 p.m. EST",13444,13340,10393,-3051
ISNE,"11/17/2017 3 p.m. EST",13760,13550,10753,-3007
ISNE,"11/17/2017 4 p.m. EST",14362,14030,11351,-3011
ISNE,"11/17/2017 5 p.m. EST",15391,15160,12178,-3213
ISNE,"11/17/2017 6 p.m. EST",16206,16100,13274,-2932
ISNE,"11/17/2017 7 p.m. EST",16018,15850,12974,-3044
ISNE,"11/17/2017 8 p.m. EST",15579,15360,12434,-3145
ISNE,"11/17/2017 9 p.m. EST",15081,14830,12133,-2948
ISNE,"11/17/2017 10 p.m. EST",14336,14100,11485,-2851
ISNE,"11/17/2017 11 p.m. EST",13348,13130,10548,-2800
ISNE,"11/18/2017 12 a.m. EST",12396,12130,9506,-2890
ISNE,"11/18/2017 1 a.m. EST",12086,11690,9787,-2299
ISNE,"11/18/2017 2 a.m. EST",11878,11310,9556,-2322
ISNE,"11/18/2017 3 a.m. EST",11693,11130,9158,-2535
ISNE,"11/18/2017 4 a.m. EST",11637,11080,9100,-2537
ISNE,"11/18/2017 5 a.m. EST",11782,11230,9212,-2570
ISNE,"11/18/2017 6 a.m. EST",11951,11650,9486,-2465
ISNE,"11/18/2017 7 a.m. EST",12746,12320,10152,-2594
ISNE,"11/18/2017 8 a.m. EST",13190,12800,10419,-2771
ISNE,"11/18/2017 9 a.m. EST",13570,13290,10719,-2851
ISNE,"11/18/2017 10 a.m. EST",13806,13450,11082,-2724
ISNE,"11/18/2017 11 a.m. EST",13916,13450,11514,-2402
ISNE,"11/18/2017 12 p.m. EST",13873,13290,11506,-2367
ISNE,"11/18/2017 1 p.m. EST",13805,13180,11576,-2229
ISNE,"11/18/2017 2 p.m. EST",13828,13130,11184,-2644
ISNE,"11/18/2017 3 p.m. EST",13775,13290,11039,-2736
ISNE,"11/18/2017 4 p.m. EST",13969,13550,11124,-2845
ISNE,"11/18/2017 5 p.m. EST",14774,14520,11615,-3159
ISNE,"11/18/2017 6 p.m. EST",15187,15100,12413,-2774
ISNE,"11/18/2017 7 p.m. EST",14854,14800,11940,-2914
ISNE,"11/18/2017 8 p.m. EST",14290,14190,11236,-3054
ISNE,"11/18/2017 9 p.m. EST",13745,13700,10849,-2896
ISNE,"11/18/2017 10 p.m. EST",13020,12970,10213,-2807
ISNE,"11/18/2017 11 p.m. EST",12169,12080,9150,-3019
ISNE,"11/19/2017 12 a.m. EST",11728,11490,8863,-2865
ISNE,"11/19/2017 1 a.m. EST",11369,10530,8507,-2862
ISNE,"11/19/2017 2 a.m. EST",11144,10050,8123,-3021
ISNE,"11/19/2017 3 a.m. EST",11043,9760,8106,-2937
ISNE,"11/19/2017 4 a.m. EST",10954,9630,8057,-2897
ISNE,"11/19/2017 5 a.m. EST",10964,9640,7992,-2972
ISNE,"11/19/2017 6 a.m. EST",11226,9960,8147,-3079
ISNE,"11/19/2017 7 a.m. EST",11745,10410,8505,-3240
ISNE,"11/19/2017 8 a.m. EST",11985,11120,8852,-3133
ISNE,"11/19/2017 9 a.m. EST",12609,11750,9527,-3082
ISNE,"11/19/2017 10 a.m. EST",13044,12170,9798,-3246
ISNE,"11/19/2017 11 a.m. EST",13001,12400,9894,-3107
ISNE,"11/19/2017 12 p.m. EST",12856,12460,9817,-3039
ISNE,"11/19/2017 1 p.m. EST",12551,12440,9626,-2925
ISNE,"11/19/2017 2 p.m. EST",12365,12560,9422,-2943
ISNE,"11/19/2017 3 p.m. EST",12651,12740,9957,-2694
ISNE,"11/19/2017 4 p.m. EST",13274,13240,10757,-2517
ISNE,"11/19/2017 5 p.m. EST",14514,14420,12043,-2471
ISNE,"11/19/2017 6 p.m. EST",15423,15400,12805,-2618
ISNE,"11/19/2017 7 p.m. EST",15251,15170,12378,-2873
ISNE,"11/19/2017 8 p.m. EST",14860,14750,12202,-2658
ISNE,"11/19/2017 9 p.m. EST",14347,14030,11619,-2728
ISNE,"11/19/2017 10 p.m. EST",13488,13130,10847,-2641
ISNE,"11/19/2017 11 p.m. EST",12722,12160,9985,-2737
ISNE,"11/20/2017 12 a.m. EST",12036,11290,9098,-2938
ISNE,"11/20/2017 1 a.m. EST",11493,10890,8475,-3018
ISNE,"11/20/2017 2 a.m. EST",11381,10570,8223,-3158
ISNE,"11/20/2017 3 a.m. EST",11296,10500,8226,-3070
ISNE,"11/20/2017 4 a.m. EST",11381,10580,8412,-2969
ISNE,"11/20/2017 5 a.m. EST",11811,11030,8952,-2859
ISNE,"11/20/2017 6 a.m. EST",12531,12060,9628,-2903
ISNE,"11/20/2017 7 a.m. EST",13986,14050,11098,-2888
ISNE,"11/20/2017 8 a.m. EST",14833,14860,12072,-2761
ISNE,"11/20/2017 9 a.m. EST",14665,14660,11994,-2671
ISNE,"11/20/2017 10 a.m. EST",14331,14400,11766,-2565
ISNE,"11/20/2017 11 a.m. EST",14285,14230,11693,-2592
ISNE,"11/20/2017 12 p.m. EST",14316,14030,11647,-2669
ISNE,"11/20/2017 1 p.m. EST",14245,14030,11404,-2841
ISNE,"11/20/2017 2 p.m. EST",14323,14170,11443,-2880
ISNE,"11/20/2017 3 p.m. EST",14535,14390,11621,-2914
ISNE,"11/20/2017 4 p.m. EST",14991,14970,12107,-2884
ISNE,"11/20/2017 5 p.m. EST",16042,16070,13274,-2768
ISNE,"11/20/2017 6 p.m. EST",16782,17000,14009,-2773
ISNE,"11/20/2017 7 p.m. EST",16644,16730,13632,-3012
ISNE,"11/20/2017 8 p.m. EST",16241,16180,13151,-3090
ISNE,"11/20/2017 9 p.m. EST",15577,15400,12664,-2913
ISNE,"11/20/2017 10 p.m. EST",14538,14310,11641,-2897
ISNE,"11/20/2017 11 p.m. EST",13243,13040,10360,-2883
ISNE,"11/21/2017 12 a.m. EST",12122,11880,9106,-3016
ISNE,"11/21/2017 1 a.m. EST",11587,11330,8753,-2834
ISNE,"11/21/2017 2 a.m. EST",11325,10950,8431,-2894
ISNE,"11/21/2017 3 a.m. EST",11532,10790,8736,-2796
ISNE,"11/21/2017 4 a.m. EST",11395,10810,8651,-2744
ISNE,"11/21/2017 5 a.m. EST",11456,11180,8778,-2678
ISNE,"11/21/2017 6 a.m. EST",12250,12290,9802,-2448
ISNE,"11/21/2017 7 a.m. EST",13999,14050,11444,-2555
ISNE,"11/21/2017 8 a.m. EST",14760,14840,12364,-2396
ISNE,"11/21/2017 9 a.m. EST",14451,14420,12048,-2403
ISNE,"11/21/2017 10 a.m. EST",13807,13890,11355,-2452
ISNE,"11/21/2017 11 a.m. EST",13388,13600,10735,-2653
ISNE,"11/21/2017 12 p.m. EST",13164,13330,10538,-2626
ISNE,"11/21/2017 1 p.m. EST",13277,13230,10505,-2772
ISNE,"11/21/2017 2 p.m. EST",13286,13280,10683,-2603
ISNE,"11/21/2017 3 p.m. EST",13746,13440,11098,-2648
ISNE,"11/21/2017 4 p.m. EST",14000,13920,11508,-2492
ISNE,"11/21/2017 5 p.m. EST",14966,15140,12224,-2742
ISNE,"11/21/2017 6 p.m. EST",15823,16050,13283,-2540
ISNE,"11/21/2017 7 p.m. EST",15686,15910,13111,-2575
ISNE,"11/21/2017 8 p.m. EST",15275,15420,12701,-2574
ISNE,"11/21/2017 9 p.m. EST",14654,14760,12061,-2593
ISNE,"11/21/2017 10 p.m. EST",13733,13710,11110,-2623
ISNE,"11/21/2017 11 p.m. EST",12662,12470,9790,-2872
ISNE,"11/22/2017 12 a.m. EST",11850,11320,8819,-3031
ISNE,"11/22/2017 1 a.m. EST",11673,10520,8960,-2713
ISNE,"11/22/2017 2 a.m. EST",11288,10060,8753,-2535
ISNE,"11/22/2017 3 a.m. EST",11057,9880,8644,-2413
ISNE,"11/22/2017 4 a.m. EST",11033,9860,8647,-2386
ISNE,"11/22/2017 5 a.m. EST",11305,10190,8801,-2504
ISNE,"11/22/2017 6 a.m. EST",11620,11220,9343,-2277
ISNE,"11/22/2017 7 a.m. EST",12930,13020,10537,-2393
ISNE,"11/22/2017 8 a.m. EST",13905,13960,11420,-2485
ISNE,"11/22/2017 9 a.m. EST",14577,14120,12179,-2398
ISNE,"11/22/2017 10 a.m. EST",14952,15000,12664,-2288
ISNE,"11/22/2017 11 a.m. EST",15238,15010,12780,-2458
ISNE,"11/22/2017 12 p.m. EST",15340,14920,12819,-2521
ISNE,"11/22/2017 1 p.m. EST",15215,14880,12353,-2862
ISNE,"11/22/2017 2 p.m. EST",15156,14950,12257,-2899
ISNE,"11/22/2017 3 p.m. EST",15027,14990,12175,-2852
ISNE,"11/22/2017 4 p.m. EST",15018,14990,12135,-2883
ISNE,"11/22/2017 5 p.m. EST",15573,15470,12520,-3053
ISNE,"11/22/2017 6 p.m. EST",16068,16600,13229,-2839
ISNE,"11/22/2017 7 p.m. EST",15787,16270,13016,-2771
ISNE,"11/22/2017 8 p.m. EST",15310,15620,12576,-2734
ISNE,"11/22/2017 9 p.m. EST",14757,15020,12238,-2519
ISNE,"11/22/2017 10 p.m. EST",13963,14060,11619,-2344
ISNE,"11/22/2017 11 p.m. EST",12919,12850,10588,-2331
ISNE,"11/23/2017 12 a.m. EST",12113,11850,9836,-2277
ISNE,"11/23/2017 1 a.m. EST",11523,11130,9559,-1964
ISNE,"11/23/2017 2 a.m. EST",11390,10690,9314,-2076
ISNE,"11/23/2017 3 a.m. EST",11696,10460,9581,-2115
ISNE,"11/23/2017 4 a.m. EST",11647,10430,9673,-1974
ISNE,"11/23/2017 5 a.m. EST",11639,10610,9830,-1809
ISNE,"11/23/2017 6 a.m. EST",11815,11120,9896,-1919
ISNE,"11/23/2017 7 a.m. EST",11928,11860,9813,-2115
ISNE,"11/23/2017 8 a.m. EST",12595,12590,10311,-2284
ISNE,"11/23/2017 9 a.m. EST",13105,13110,10876,-2229
ISNE,"11/23/2017 10 a.m. EST",13324,13450,11149,-2175
ISNE,"11/23/2017 11 a.m. EST",13368,13520,11485,-1883
ISNE,"11/23/2017 12 p.m. EST",13334,13510,11431,-1903
ISNE,"11/23/2017 1 p.m. EST",13037,13090,11162,-1875
ISNE,"11/23/2017 2 p.m. EST",12565,12360,10725,-1840
ISNE,"11/23/2017 3 p.m. EST",12299,11890,10350,-1949
ISNE,"11/23/2017 4 p.m. EST",12386,11880,10220,-2166
ISNE,"11/23/2017 5 p.m. EST",12906,12560,10674,-2232
ISNE,"11/23/2017 6 p.m. EST",13225,13150,10931,-2294
ISNE,"11/23/2017 7 p.m. EST",13165,13110,10687,-2478
ISNE,"11/23/2017 8 p.m. EST",13122,13090,10627,-2495
ISNE,"11/23/2017 9 p.m. EST",13024,12900,10601,-2423
ISNE,"11/23/2017 10 p.m. EST",12705,12590,10422,-2283
ISNE,"11/23/2017 11 p.m. EST",12115,11970,9881,-2234
ISNE,"11/24/2017 12 a.m. EST",11598,11280,9600,-1998
ISNE,"11/24/2017 1 a.m. EST",11214,10850,9200,-2014
ISNE,"11/24/2017 2 a.m. EST",10691,10560,8704,-1987
ISNE,"11/24/2017 3 a.m. EST",10722,10480,8686,-2036
ISNE,"11/24/2017 4 a.m. EST",10814,10480,8860,-1954
ISNE,"11/24/2017 5 a.m. EST",10963,10760,8850,-2113
ISNE,"11/24/2017 6 a.m. EST",11384,11330,9633,-1751
ISNE,"11/24/2017 7 a.m. EST",12179,11980,10347,-1832
ISNE,"11/24/2017 8 a.m. EST",12705,12470,10778,-1927
ISNE,"11/24/2017 9 a.m. EST",12860,12730,10923,-1937
ISNE,"11/24/2017 10 a.m. EST",12676,12550,10635,-2041
ISNE,"11/24/2017 11 a.m. EST",12451,12210,10178,-2273
ISNE,"11/24/2017 12 p.m. EST",12232,12060,10234,-1998
ISNE,"11/24/2017 1 p.m. EST",12026,11940,10001,-2025
ISNE,"11/24/2017 2 p.m. EST",12026,11740,9780,-2246
ISNE,"11/24/2017 3 p.m. EST",12347,11900,10112,-2235
ISNE,"11/24/2017 4 p.m. EST",12949,12420,10895,-2054
ISNE,"11/24/2017 5 p.m. EST",14009,13880,11871,-2138
ISNE,"11/24/2017 6 p.m. EST",14799,14870,12723,-2076
ISNE,"11/24/2017 7 p.m. EST",14593,14620,12357,-2236
ISNE,"11/24/2017 8 p.m. EST",14219,14120,11829,-2390
ISNE,"11/24/2017 9 p.m. EST",13770,13670,11475,-2295
ISNE,"11/24/2017 10 p.m. EST",13153,13160,10803,-2350
ISNE,"11/24/2017 11 p.m. EST",12358,12290,9934,-2424
ISNE,"11/25/2017 12 a.m. EST",11439,11410,9280,-2159
ISNE,"11/25/2017 1 a.m. EST",11019,10860,9134,-1885
ISNE,"11/25/2017 2 a.m. EST",10646,10440,8606,-2040
ISNE,"11/25/2017 3 a.m. EST",10813,10200,8501,-2312
ISNE,"11/25/2017 4 a.m. EST",10934,10120,8739,-2195
ISNE,"11/25/2017 5 a.m. EST",11040,10240,8857,-2183
ISNE,"11/25/2017 6 a.m. EST",11173,10670,8952,-2221
ISNE,"11/25/2017 7 a.m. EST",11304,11360,9297,-2007
ISNE,"11/25/2017 8 a.m. EST",11831,11910,10102,-1729
ISNE,"11/25/2017 9 a.m. EST",12138,12330,10321,-1817
ISNE,"11/25/2017 10 a.m. EST",12072,12380,10265,-1807
ISNE,"11/25/2017 11 a.m. EST",11914,12220,9960,-1954
ISNE,"11/25/2017 12 p.m. EST",11791,12050,9598,-2193
ISNE,"11/25/2017 1 p.m. EST",11702,11990,9580,-2122
ISNE,"11/25/2017 2 p.m. EST",11681,11920,9591,-2090
ISNE,"11/25/2017 3 p.m. EST",12025,12080,9878,-2147
ISNE,"11/25/2017 4 p.m. EST",12547,12640,10304,-2243
ISNE,"11/25/2017 5 p.m. EST",13603,13790,11516,-2087
ISNE,"11/25/2017 6 p.m. EST",14274,14620,12472,-1802
ISNE,"11/25/2017 7 p.m. EST",14057,14240,12011,-2046
ISNE,"11/25/2017 8 p.m. EST",13685,13800,11618,-2067
ISNE,"11/25/2017 9 p.m. EST",13240,13350,11154,-2086
ISNE,"11/25/2017 10 p.m. EST",12591,12690,10489,-2102
ISNE,"11/25/2017 11 p.m. EST",11758,11860,9436,-2322
ISNE,"11/26/2017 12 a.m. EST",10963,11030,8629,-2334
ISNE,"11/26/2017 1 a.m. EST",10487,10150,7895,-2592
ISNE,"11/26/2017 2 a.m. EST",10357,9750,7724,-2633
ISNE,"11/26/2017 3 a.m. EST",10309,9510,7684,-2625
ISNE,"11/26/2017 4 a.m. EST",10225,9430,7618,-2607
ISNE,"11/26/2017 5 a.m. EST",9915,9550,7519,-2396
ISNE,"11/26/2017 6 a.m. EST",10093,9900,7643,-2450
ISNE,"11/26/2017 7 a.m. EST",10620,10390,8016,-2604
ISNE,"11/26/2017 8 a.m. EST",11141,11120,8732,-2409
ISNE,"11/26/2017 9 a.m. EST",11440,11630,9330,-2110
ISNE,"11/26/2017 10 a.m. EST",11805,11800,9856,-1949
ISNE,"11/26/2017 11 a.m. EST",12174,11840,10270,-1904
ISNE,"11/26/2017 12 p.m. EST",12261,11890,10584,-1677
ISNE,"11/26/2017 1 p.m. EST",12270,11950,10641,-1629
ISNE,"11/26/2017 2 p.m. EST",12352,11960,10757,-1595
ISNE,"11/26/2017 3 p.m. EST",12677,12200,10867,-1810
ISNE,"11/26/2017 4 p.m. EST",13395,12800,11344,-2051
ISNE,"11/26/2017 5 p.m. EST",14744,14220,12608,-2136
ISNE,"11/26/2017 6 p.m. EST",15648,15420,13728,-1920
ISNE,"11/26/2017 7 p.m. EST",15537,15220,13567,-1970
ISNE,"11/26/2017 8 p.m. EST",15125,14990,13153,-1972
ISNE,"11/26/2017 9 p.m. EST",14520,14330,12769,-1751
ISNE,"11/26/2017 10 p.m. EST",13588,13440,11589,-1999
ISNE,"11/26/2017 11 p.m. EST",12466,12460,10218,-2248
ISNE,"11/27/2017 12 a.m. EST",11560,11500,9136,-2424
ISNE,"11/27/2017 1 a.m. EST",11634,10860,9107,-2527
ISNE,"11/27/2017 2 a.m. EST",11555,10560,8992,-2563
ISNE,"11/27/2017 3 a.m. EST",11735,10410,9000,-2735
ISNE,"11/27/2017 4 a.m. EST",11777,10480,8957,-2820
ISNE,"11/27/2017 5 a.m. EST",11974,10880,9092,-2882
ISNE,"11/27/2017 6 a.m. EST",12732,12050,10008,-2724
ISNE,"11/27/2017 7 a.m. EST",13858,13860,11493,-2365
ISNE,"11/27/2017 8 a.m. EST",14850,14750,12468,-2382
ISNE,"11/27/2017 9 a.m. EST",15015,14470,12518,-2497
ISNE,"11/27/2017 10 a.m. EST",14757,14150,12393,-2364
ISNE,"11/27/2017 11 a.m. EST",14498,13930,11997,-2501
ISNE,"11/27/2017 12 p.m. EST",14447,13800,12064,-2383
ISNE,"11/27/2017 1 p.m. EST",14256,13900,11949,-2307
ISNE,"11/27/2017 2 p.m. EST",14202,13920,12268,-1934
ISNE,"11/27/2017 3 p.m. EST",14313,14090,12487,-1826
ISNE,"11/27/2017 4 p.m. EST",14755,14590,12582,-2173
ISNE,"11/27/2017 5 p.m. EST",15937,15860,13847,-2090
ISNE,"11/27/2017 6 p.m. EST",16899,16840,15185,-1714
ISNE,"11/27/2017 7 p.m. EST",16858,16690,14940,-1918
ISNE,"11/27/2017 8 p.m. EST",16485,16270,14233,-2252
ISNE,"11/27/2017 9 p.m. EST",15884,15640,13385,-2499
ISNE,"11/27/2017 10 p.m. EST",14882,14600,12252,-2630
ISNE,"11/27/2017 11 p.m. EST",13585,13340,10936,-2649
ISNE,"11/28/2017 12 a.m. EST",12547,12220,10141,-2406
ISNE,"11/28/2017 1 a.m. EST",12113,11700,9950,-2163
ISNE,"11/28/2017 2 a.m. EST",12011,11380,9915,-2096
ISNE,"11/28/2017 3 a.m. EST",12166,11280,9861,-2305
ISNE,"11/28/2017 4 a.m. EST",12264,11320,9836,-2428
ISNE,"11/28/2017 5 a.m. EST",12448,11830,10147,-2301
ISNE,"11/28/2017 6 a.m. EST",13288,12810,11279,-2009
ISNE,"11/28/2017 7 a.m. EST",14888,14690,12676,-2212
ISNE,"11/28/2017 8 a.m. EST",15753,15460,13406,-2347
ISNE,"11/28/2017 9 a.m. EST",15457,15220,12926,-2531
ISNE,"11/28/2017 10 a.m. EST",14856,14860,12323,-2533
ISNE,"11/28/2017 11 a.m. EST",14416,14480,11750,-2666
ISNE,"11/28/2017 12 p.m. EST",14078,14150,11466,-2612
ISNE,"11/28/2017 1 p.m. EST",13872,13960,11329,-2543
ISNE,"11/28/2017 2 p.m. EST",13946,14010,11436,-2510
ISNE,"11/28/2017 3 p.m. EST",14262,14200,11799,-2463
ISNE,"11/28/2017 4 p.m. EST",14866,14590,12336,-2530
ISNE,"11/28/2017 5 p.m. EST",16052,15900,13589,-2463
ISNE,"11/28/2017 6 p.m. EST",16992,16800,14543,-2449
ISNE,"11/28/2017 7 p.m. EST",16848,16630,14292,-2556
ISNE,"11/28/2017 8 p.m. EST",16418,16160,13800,-2618
ISNE,"11/28/2017 9 p.m. EST",15686,15410,13206,-2480
ISNE,"11/28/2017 10 p.m. EST",14553,14320,12222,-2331
ISNE,"11/28/2017 11 p.m. EST",13189,12980,10852,-2337
ISNE,"11/29/2017 12 a.m. EST",12161,11750,9871,-2290
ISNE,"11/29/2017 1 a.m. EST",11354,11060,9043,-2311
ISNE,"11/29/2017 2 a.m. EST",11137,10620,9064,-2073
ISNE,"11/29/2017 3 a.m. EST",11171,10400,9273,-1898
ISNE,"11/29/2017 4 a.m. EST",11148,10360,9286,-1862
ISNE,"11/29/2017 5 a.m. EST",11254,10700,9452,-1802
ISNE,"11/29/2017 6 a.m. EST",12019,11800,10096,-1923
ISNE,"11/29/2017 7 a.m. EST",13449,13530,11803,-1646
ISNE,"11/29/2017 8 a.m. EST",14290,14400,12277,-2013
ISNE,"11/29/2017 9 a.m. EST",14304,14390,12266,-2038
ISNE,"11/29/2017 10 a.m. EST",14009,14070,11868,-2141
ISNE,"11/29/2017 11 a.m. EST",13567,13690,11504,-2063
ISNE,"11/29/2017 12 p.m. EST",13250,13530,11289,-1961
ISNE,"11/29/2017 1 p.m. EST",13183,13440,11468,-1715
ISNE,"11/29/2017 2 p.m. EST",13806,13510,12035,-1771
ISNE,"11/29/2017 3 p.m. EST",14045,13640,12182,-1863
ISNE,"11/29/2017 4 p.m. EST",14125,14040,12248,-1877
ISNE,"11/29/2017 5 p.m. EST",15239,15300,13072,-2167
ISNE,"11/29/2017 6 p.m. EST",16233,16300,14050,-2183
ISNE,"11/29/2017 7 p.m. EST",16175,16160,13956,-2219
ISNE,"11/29/2017 8 p.m. EST",15795,15680,13702,-2093
ISNE,"11/29/2017 9 p.m. EST",15188,15100,13138,-2050
ISNE,"11/29/2017 10 p.m. EST",14231,14190,12158,-2073
ISNE,"11/29/2017 11 p.m. EST",12966,12960,10784,-2182
ISNE,"11/30/2017 12 a.m. EST",12027,11890,9826,-2201
ISNE,"11/30/2017 1 a.m. EST",11634,11240,9454,-2180
ISNE,"11/30/2017 2 a.m. EST",11380,10890,9192,-2188
ISNE,"11/30/2017 3 a.m. EST",11548,10750,9080,-2468
ISNE,"11/30/2017 4 a.m. EST",11630,10820,9015,-2615
ISNE,"11/30/2017 5 a.m. EST",11821,11240,9391,-2430
ISNE,"11/30/2017 6 a.m. EST",12740,12390,10284,-2456
ISNE,"11/30/2017 7 a.m. EST",14376,14250,11901,-2475
ISNE,"11/30/2017 8 a.m. EST",15268,14980,12549,-2719
ISNE,"11/30/2017 9 a.m. EST",15044,14880,12508,-2536
ISNE,"11/30/2017 10 a.m. EST",14575,14740,12181,-2394
ISNE,"11/30/2017 11 a.m. EST",14441,14620,12179,-2262
ISNE,"11/30/2017 12 p.m. EST",14318,14480,11904,-2414
ISNE,"11/30/2017 1 p.m. EST",14267,14320,11779,-2488
ISNE,"11/30/2017 2 p.m. EST",14327,14390,11823,-2504
ISNE,"11/30/2017 3 p.m. EST",14446,14550,11938,-2508
ISNE,"11/30/2017 4 p.m. EST",14777,14940,12277,-2500
ISNE,"11/30/2017 5 p.m. EST",15907,16070,13313,-2594
ISNE,"11/30/2017 6 p.m. EST",16630,16700,14103,-2527
ISNE,"11/30/2017 7 p.m. EST",16484,16340,13948,-2536
ISNE,"11/30/2017 8 p.m. EST",16091,15840,13537,-2554
ISNE,"11/30/2017 9 p.m. EST",15451,15180,13029,-2422
ISNE,"11/30/2017 10 p.m. EST",14423,14150,11988,-2435
ISNE,"11/30/2017 11 p.m. EST",13039,12820,10545,-2494
ISNE,"12/1/2017 12 a.m. EST",12065,11660,9786,-2279
