"BA Code","Timestamp (Hour Ending)","Demand (MWh)","Demand Forecast (MWh)","Net Generation (MWh)","Total Interchange (MWh)"
ISNE,"3/1/2020 12 a.m. EST",14300,12630,12276,-2024
ISNE,"3/1/2020 1 a.m. EST",13383,12240,11297,-2086
ISNE,"3/1/2020 2 a.m. EST",11920,11890,9666,-2254
ISNE,"3/1/2020 3 a.m. EST",12244,11730,9723,-2521
ISNE,"3/1/2020 4 a.m. EST",12213,11700,9751,-2462
ISNE,"3/1/2020 5 a.m. EST",12072,11830,9771,-2301
ISNE,"3/1/2020 6 a.m. EST",12226,12150,9958,-2268
ISNE,"3/1/2020 7 a.m. EST",12605,12620,10555,-2050
ISNE,"3/1/2020 8 a.m. EST",12924,12750,10522,-2402
ISNE,"3/1/2020 9 a.m. EST",12923,12670,10706,-2217
ISNE,"3/1/2020 10 a.m. EST",12834,12570,10546,-2288
ISNE,"3/1/2020 11 a.m. EST",12593,12330,10442,-2151
ISNE,"3/1/2020 12 p.m. EST",12453,11840,9690,-2763
ISNE,"3/1/2020 1 p.m. EST",12301,11410,9859,-2442
ISNE,"3/1/2020 2 p.m. EST",12056,11350,9660,-2396
ISNE,"3/1/2020 3 p.m. EST",12373,11660,9728,-2645
ISNE,"3/1/2020 4 p.m. EST",12860,12420,10140,-2720
ISNE,"3/1/2020 5 p.m. EST",13829,13640,11230,-2599
ISNE,"3/1/2020 6 p.m. EST",15004,14990,12079,-2925
ISNE,"3/1/2020 7 p.m. EST",15722,15350,12801,-2921
ISNE,"3/1/2020 8 p.m. EST",15511,15140,12605,-2906
ISNE,"3/1/2020 9 p.m. EST",15026,14630,12085,-2941
ISNE,"3/1/2020 10 p.m. EST",14201,13840,11060,-3141
ISNE,"3/1/2020 11 p.m. EST",13200,12900,10102,-3098
ISNE,"3/2/2020 12 a.m. EST",12374,12080,9364,-3010
ISNE,"3/2/2020 1 a.m. EST",11851,11830,8888,-2963
ISNE,"3/2/2020 2 a.m. EST",11563,11540,8553,-3010
ISNE,"3/2/2020 3 a.m. EST",11444,11430,8599,-2845
ISNE,"3/2/2020 4 a.m. EST",11484,11480,8727,-2757
ISNE,"3/2/2020 5 a.m. EST",11856,11850,9210,-2646
ISNE,"3/2/2020 6 a.m. EST",12896,12930,10860,-2036
ISNE,"3/2/2020 7 a.m. EST",14474,14500,12310,-2164
ISNE,"3/2/2020 8 a.m. EST",14903,14880,12350,-2553
ISNE,"3/2/2020 9 a.m. EST",14366,14350,11903,-2463
ISNE,"3/2/2020 10 a.m. EST",13918,13890,11743,-2175
ISNE,"3/2/2020 11 a.m. EST",13463,13430,11697,-1766
ISNE,"3/2/2020 12 p.m. EST",13262,13110,11732,-1530
ISNE,"3/2/2020 1 p.m. EST",12880,12650,11275,-1605
ISNE,"3/2/2020 2 p.m. EST",12670,12100,10955,-1715
ISNE,"3/2/2020 3 p.m. EST",12571,12230,10785,-1786
ISNE,"3/2/2020 4 p.m. EST",12617,12670,10997,-1620
ISNE,"3/2/2020 5 p.m. EST",13607,13530,11933,-1674
ISNE,"3/2/2020 6 p.m. EST",14748,14680,12827,-1921
ISNE,"3/2/2020 7 p.m. EST",15302,15370,13363,-1939
ISNE,"3/2/2020 8 p.m. EST",14936,15080,12818,-2118
ISNE,"3/2/2020 9 p.m. EST",14307,14440,12294,-2013
ISNE,"3/2/2020 10 p.m. EST",13314,13460,11330,-1984
ISNE,"3/2/2020 11 p.m. EST",12133,12290,9912,-2221
ISNE,"3/3/2020 12 a.m. EST",11113,11320,8915,-2198
ISNE,"3/3/2020 1 a.m. EST",10738,10570,8330,-2408
ISNE,"3/3/2020 2 a.m. EST",10759,10240,8305,-2454
ISNE,"3/3/2020 3 a.m. EST",10757,10090,8258,-2499
ISNE,"3/3/2020 4 a.m. EST",10690,10080,8225,-2465
ISNE,"3/3/2020 5 a.m. EST",10801,10390,8248,-2553
ISNE,"3/3/2020 6 a.m. EST",11563,11420,8941,-2622
ISNE,"3/3/2020 7 a.m. EST",12858,12930,10359,-2499
ISNE,"3/3/2020 8 a.m. EST",13281,13400,10820,-2461
ISNE,"3/3/2020 9 a.m. EST",12607,13060,10363,-2244
ISNE,"3/3/2020 10 a.m. EST",11961,11980,9612,-2349
ISNE,"3/3/2020 11 a.m. EST",11550,11750,9547,-2003
ISNE,"3/3/2020 12 p.m. EST",11470,11480,9469,-2001
ISNE,"3/3/2020 1 p.m. EST",11589,11410,9803,-1786
ISNE,"3/3/2020 2 p.m. EST",11867,11670,10182,-1685
ISNE,"3/3/2020 3 p.m. EST",12347,12110,10703,-1644
ISNE,"3/3/2020 4 p.m. EST",12683,12650,10877,-1806
ISNE,"3/3/2020 5 p.m. EST",13354,13400,11568,-1786
ISNE,"3/3/2020 6 p.m. EST",14277,14260,12293,-1984
ISNE,"3/3/2020 7 p.m. EST",14703,14850,12762,-1941
ISNE,"3/3/2020 8 p.m. EST",14348,14500,12412,-1936
ISNE,"3/3/2020 9 p.m. EST",13766,13850,11878,-1888
ISNE,"3/3/2020 10 p.m. EST",12813,12850,11285,-1528
ISNE,"3/3/2020 11 p.m. EST",11664,11720,10309,-1355
ISNE,"3/4/2020 12 a.m. EST",10826,10750,9452,-1374
ISNE,"3/4/2020 1 a.m. EST",10613,10060,8851,-1762
ISNE,"3/4/2020 2 a.m. EST",10544,9750,8471,-2073
ISNE,"3/4/2020 3 a.m. EST",10417,9620,8243,-2174
ISNE,"3/4/2020 4 a.m. EST",10449,9660,8360,-2089
ISNE,"3/4/2020 5 a.m. EST",10812,10050,8831,-1981
ISNE,"3/4/2020 6 a.m. EST",11495,11110,9684,-1811
ISNE,"3/4/2020 7 a.m. EST",12643,12670,10886,-1757
ISNE,"3/4/2020 8 a.m. EST",13192,13150,11768,-1424
ISNE,"3/4/2020 9 a.m. EST",12902,12830,11682,-1220
ISNE,"3/4/2020 10 a.m. EST",12666,12600,11557,-1109
ISNE,"3/4/2020 11 a.m. EST",12566,12170,11549,-1017
ISNE,"3/4/2020 12 p.m. EST",12343,11990,11335,-1008
ISNE,"3/4/2020 1 p.m. EST",12139,11880,10829,-1310
ISNE,"3/4/2020 2 p.m. EST",12107,11870,10256,-1851
ISNE,"3/4/2020 3 p.m. EST",11988,12060,10562,-1426
ISNE,"3/4/2020 4 p.m. EST",12323,12490,11187,-1136
ISNE,"3/4/2020 5 p.m. EST",13242,13340,11971,-1271
ISNE,"3/4/2020 6 p.m. EST",14402,14410,12896,-1506
ISNE,"3/4/2020 7 p.m. EST",15060,15070,12696,-2364
ISNE,"3/4/2020 8 p.m. EST",14792,14720,12633,-2159
ISNE,"3/4/2020 9 p.m. EST",14214,14140,11993,-2221
ISNE,"3/4/2020 10 p.m. EST",13320,13250,11286,-2034
ISNE,"3/4/2020 11 p.m. EST",12240,12140,10291,-1949
ISNE,"3/5/2020 12 a.m. EST",11538,11160,9381,-2157
ISNE,"3/5/2020 1 a.m. EST",11261,10370,8487,-2774
ISNE,"3/5/2020 2 a.m. EST",11105,10060,8317,-2788
ISNE,"3/5/2020 3 a.m. EST",10745,9930,8425,-2320
ISNE,"3/5/2020 4 a.m. EST",10991,10040,8407,-2584
ISNE,"3/5/2020 5 a.m. EST",11300,10220,8733,-2567
ISNE,"3/5/2020 6 a.m. EST",11968,11330,9658,-2310
ISNE,"3/5/2020 7 a.m. EST",13202,12840,10590,-2612
ISNE,"3/5/2020 8 a.m. EST",13459,13350,10837,-2622
ISNE,"3/5/2020 9 a.m. EST",12670,12750,10283,-2387
ISNE,"3/5/2020 10 a.m. EST",11979,11960,9830,-2149
ISNE,"3/5/2020 11 a.m. EST",11577,11490,9513,-2064
ISNE,"3/5/2020 12 p.m. EST",11312,11290,8834,-2478
ISNE,"3/5/2020 1 p.m. EST",11088,11100,8971,-2117
ISNE,"3/5/2020 2 p.m. EST",11047,11050,9117,-1930
ISNE,"3/5/2020 3 p.m. EST",11214,11120,9330,-1884
ISNE,"3/5/2020 4 p.m. EST",11858,11600,9547,-2311
ISNE,"3/5/2020 5 p.m. EST",12916,12570,10235,-2681
ISNE,"3/5/2020 6 p.m. EST",14109,13770,11060,-3049
ISNE,"3/5/2020 7 p.m. EST",14888,14850,12165,-2723
ISNE,"3/5/2020 8 p.m. EST",14686,14430,12052,-2634
ISNE,"3/5/2020 9 p.m. EST",14196,13920,11777,-2419
ISNE,"3/5/2020 10 p.m. EST",13408,13110,10813,-2595
ISNE,"3/5/2020 11 p.m. EST",12472,12100,9597,-2875
ISNE,"3/6/2020 12 a.m. EST",11698,11130,8571,-3127
ISNE,"3/6/2020 1 a.m. EST",11137,10630,8577,-2560
ISNE,"3/6/2020 2 a.m. EST",10998,10260,8443,-2555
ISNE,"3/6/2020 3 a.m. EST",10944,10110,8393,-2551
ISNE,"3/6/2020 4 a.m. EST",10814,10130,8301,-2513
ISNE,"3/6/2020 5 a.m. EST",11193,10460,8464,-2729
ISNE,"3/6/2020 6 a.m. EST",12212,11340,9316,-2896
ISNE,"3/6/2020 7 a.m. EST",13504,12530,10688,-2816
ISNE,"3/6/2020 8 a.m. EST",13838,13110,11065,-2773
ISNE,"3/6/2020 9 a.m. EST",13039,13060,10771,-2268
ISNE,"3/6/2020 10 a.m. EST",12336,12970,10500,-1836
ISNE,"3/6/2020 11 a.m. EST",12082,12980,10464,-1618
ISNE,"3/6/2020 12 p.m. EST",12191,12960,10438,-1753
ISNE,"3/6/2020 1 p.m. EST",12550,13020,10991,-1559
ISNE,"3/6/2020 2 p.m. EST",13187,13240,11418,-1769
ISNE,"3/6/2020 3 p.m. EST",13539,13420,11747,-1792
ISNE,"3/6/2020 4 p.m. EST",13796,13640,11887,-1909
ISNE,"3/6/2020 5 p.m. EST",14235,14000,12393,-1842
ISNE,"3/6/2020 6 p.m. EST",14872,14670,12626,-2246
ISNE,"3/6/2020 7 p.m. EST",15050,14990,12566,-2484
ISNE,"3/6/2020 8 p.m. EST",14668,14590,11901,-2767
ISNE,"3/6/2020 9 p.m. EST",14168,14050,11365,-2803
ISNE,"3/6/2020 10 p.m. EST",13476,13360,11041,-2435
ISNE,"3/6/2020 11 p.m. EST",12680,12500,10296,-2384
ISNE,"3/7/2020 12 a.m. EST",11999,11690,10014,-1985
ISNE,"3/7/2020 1 a.m. EST",11399,11140,9382,-2017
ISNE,"3/7/2020 2 a.m. EST",11067,10810,8995,-2072
ISNE,"3/7/2020 3 a.m. EST",11115,10700,9213,-1902
ISNE,"3/7/2020 4 a.m. EST",11114,10630,9085,-2029
ISNE,"3/7/2020 5 a.m. EST",11290,10820,9369,-1921
ISNE,"3/7/2020 6 a.m. EST",11740,11260,9703,-2037
ISNE,"3/7/2020 7 a.m. EST",12163,11890,10011,-2152
ISNE,"3/7/2020 8 a.m. EST",12489,12340,10471,-2018
ISNE,"3/7/2020 9 a.m. EST",12517,12530,10474,-2043
ISNE,"3/7/2020 10 a.m. EST",12171,12180,10059,-2112
ISNE,"3/7/2020 11 a.m. EST",12025,11600,10161,-1864
ISNE,"3/7/2020 12 p.m. EST",11650,11090,9941,-1709
ISNE,"3/7/2020 1 p.m. EST",11217,10750,9417,-1800
ISNE,"3/7/2020 2 p.m. EST",10902,10440,9224,-1678
ISNE,"3/7/2020 3 p.m. EST",11054,10620,9203,-1851
ISNE,"3/7/2020 4 p.m. EST",11615,11220,9513,-2102
ISNE,"3/7/2020 5 p.m. EST",12480,12370,10339,-2141
ISNE,"3/7/2020 6 p.m. EST",13672,13390,11464,-2208
ISNE,"3/7/2020 7 p.m. EST",14410,14320,12290,-2120
ISNE,"3/7/2020 8 p.m. EST",14190,14130,11968,-2222
ISNE,"3/7/2020 9 p.m. EST",13750,13800,11632,-2118
ISNE,"3/7/2020 10 p.m. EST",13188,13300,11012,-2176
ISNE,"3/7/2020 11 p.m. EST",12437,12590,10321,-2116
ISNE,"3/8/2020 12 a.m. EST",11715,11870,9811,-1904
ISNE,"3/8/2020 1 a.m. EST",11263,11280,9155,-2108
ISNE,"3/8/2020 3 a.m. EDT",11236,10810,9123,-2113
ISNE,"3/8/2020 4 a.m. EDT",11311,10790,9065,-2246
ISNE,"3/8/2020 5 a.m. EDT",11328,10800,9052,-2276
ISNE,"3/8/2020 6 a.m. EDT",11513,11030,9301,-2212
ISNE,"3/8/2020 7 a.m. EDT",11939,11420,9787,-2152
ISNE,"3/8/2020 8 a.m. EDT",12108,11740,9875,-2233
ISNE,"3/8/2020 9 a.m. EDT",11944,11840,9678,-2266
ISNE,"3/8/2020 10 a.m. EDT",11747,11500,9431,-2316
ISNE,"3/8/2020 11 a.m. EDT",11825,11020,9350,-2475
ISNE,"3/8/2020 12 p.m. EDT",11446,10570,9291,-2155
ISNE,"3/8/2020 1 p.m. EDT",10832,10180,8693,-2139
ISNE,"3/8/2020 2 p.m. EDT",10688,10020,8623,-2065
ISNE,"3/8/2020 3 p.m. EDT",10643,9890,8426,-2217
ISNE,"3/8/2020 4 p.m. EDT",10789,10230,8411,-2378
ISNE,"3/8/2020 5 p.m. EDT",11295,11070,8726,-2569
ISNE,"3/8/2020 6 p.m. EDT",12445,12170,9640,-2805
ISNE,"3/8/2020 7 p.m. EDT",13268,13140,10526,-2742
ISNE,"3/8/2020 8 p.m. EDT",13939,13700,11213,-2726
ISNE,"3/8/2020 9 p.m. EDT",13634,13400,10927,-2707
ISNE,"3/8/2020 10 p.m. EDT",12887,12690,10010,-2877
ISNE,"3/8/2020 11 p.m. EDT",12095,11790,9214,-2881
ISNE,"3/9/2020 12 a.m. EDT",11188,10930,8622,-2566
ISNE,"3/9/2020 1 a.m. EDT",10816,10300,8148,-2668
ISNE,"3/9/2020 2 a.m. EDT",10765,9960,7915,-2850
ISNE,"3/9/2020 3 a.m. EDT",10600,9790,7598,-3002
ISNE,"3/9/2020 4 a.m. EDT",10618,9820,7652,-2966
ISNE,"3/9/2020 5 a.m. EDT",10920,10170,8060,-2860
ISNE,"3/9/2020 6 a.m. EDT",11589,11130,8843,-2746
ISNE,"3/9/2020 7 a.m. EDT",12854,12850,10192,-2662
ISNE,"3/9/2020 8 a.m. EDT",13786,13780,11128,-2658
ISNE,"3/9/2020 9 a.m. EDT",13375,13330,10551,-2824
ISNE,"3/9/2020 10 a.m. EDT",12541,12550,9917,-2624
ISNE,"3/9/2020 11 a.m. EDT",12015,11890,9515,-2500
ISNE,"3/9/2020 12 p.m. EDT",11894,11020,9001,-2893
ISNE,"3/9/2020 1 p.m. EDT",11595,10540,9056,-2539
ISNE,"3/9/2020 2 p.m. EDT",11153,10410,8762,-2391
ISNE,"3/9/2020 3 p.m. EDT",11059,10220,8530,-2529
ISNE,"3/9/2020 4 p.m. EDT",11317,10670,8891,-2426
ISNE,"3/9/2020 5 p.m. EDT",11709,11380,9295,-2414
ISNE,"3/9/2020 6 p.m. EDT",12748,12530,9976,-2772
ISNE,"3/9/2020 7 p.m. EDT",13557,13450,10567,-2990
ISNE,"3/9/2020 8 p.m. EDT",14069,14100,11108,-2961
ISNE,"3/9/2020 9 p.m. EDT",13593,13460,10809,-2784
ISNE,"3/9/2020 10 p.m. EDT",12663,12570,9796,-2867
ISNE,"3/9/2020 11 p.m. EDT",11527,11490,8691,-2836
ISNE,"3/10/2020 12 a.m. EDT",10711,10510,8099,-2612
ISNE,"3/10/2020 1 a.m. EDT",10287,9760,7571,-2716
ISNE,"3/10/2020 2 a.m. EDT",9905,9380,7400,-2505
ISNE,"3/10/2020 3 a.m. EDT",9726,9200,7432,-2294
ISNE,"3/10/2020 4 a.m. EDT",9928,9200,7627,-2301
ISNE,"3/10/2020 5 a.m. EDT",10045,9510,7902,-2143
ISNE,"3/10/2020 6 a.m. EDT",10461,10440,8316,-2145
ISNE,"3/10/2020 7 a.m. EDT",12105,12140,9232,-2873
ISNE,"3/10/2020 8 a.m. EDT",13115,13120,10015,-3100
ISNE,"3/10/2020 9 a.m. EDT",13136,13130,10171,-2965
ISNE,"3/10/2020 10 a.m. EDT",12860,12890,10288,-2572
ISNE,"3/10/2020 11 a.m. EDT",12445,12640,9917,-2528
ISNE,"3/10/2020 12 p.m. EDT",12013,12430,9426,-2587
ISNE,"3/10/2020 1 p.m. EDT",11792,12300,9148,-2644
ISNE,"3/10/2020 2 p.m. EDT",12106,12270,9678,-2428
ISNE,"3/10/2020 3 p.m. EDT",12327,12230,9880,-2447
ISNE,"3/10/2020 4 p.m. EDT",12262,12410,9684,-2578
ISNE,"3/10/2020 5 p.m. EDT",12624,12800,9920,-2704
ISNE,"3/10/2020 6 p.m. EDT",13360,13220,10510,-2850
ISNE,"3/10/2020 7 p.m. EDT",13874,13820,10902,-2972
ISNE,"3/10/2020 8 p.m. EDT",14124,14210,11093,-3031
ISNE,"3/10/2020 9 p.m. EDT",13570,13510,10563,-3007
ISNE,"3/10/2020 10 p.m. EDT",12649,12590,9715,-2934
ISNE,"3/10/2020 11 p.m. EDT",11753,11470,9043,-2710
ISNE,"3/11/2020 12 a.m. EDT",10914,10490,8565,-2349
ISNE,"3/11/2020 1 a.m. EDT",10387,9770,7367,-3020
ISNE,"3/11/2020 2 a.m. EDT",10196,9380,7434,-2762
ISNE,"3/11/2020 3 a.m. EDT",9795,9200,7354,-2441
ISNE,"3/11/2020 4 a.m. EDT",9469,9170,7315,-2154
ISNE,"3/11/2020 5 a.m. EDT",10021,9510,7570,-2451
ISNE,"3/11/2020 6 a.m. EDT",10742,10460,8248,-2494
ISNE,"3/11/2020 7 a.m. EDT",12173,12200,9643,-2530
ISNE,"3/11/2020 8 a.m. EDT",13155,13130,10488,-2667
ISNE,"3/11/2020 9 a.m. EDT",12787,12740,9838,-2949
ISNE,"3/11/2020 10 a.m. EDT",11998,12000,8992,-3006
ISNE,"3/11/2020 11 a.m. EDT",11410,11630,8917,-2493
ISNE,"3/11/2020 12 p.m. EDT",11109,11370,9019,-2090
ISNE,"3/11/2020 1 p.m. EDT",10922,11340,8891,-2031
ISNE,"3/11/2020 2 p.m. EDT",11332,11440,9202,-2130
ISNE,"3/11/2020 3 p.m. EDT",11764,11560,9247,-2517
ISNE,"3/11/2020 4 p.m. EDT",12189,11860,9623,-2566
ISNE,"3/11/2020 5 p.m. EDT",12353,12280,9617,-2736
ISNE,"3/11/2020 6 p.m. EDT",13084,13030,10191,-2893
ISNE,"3/11/2020 7 p.m. EDT",13878,13770,10851,-3027
ISNE,"3/11/2020 8 p.m. EDT",14343,14350,11305,-3038
ISNE,"3/11/2020 9 p.m. EDT",13899,13920,10969,-2930
ISNE,"3/11/2020 10 p.m. EDT",13011,13060,10308,-2703
ISNE,"3/11/2020 11 p.m. EDT",11907,11970,9561,-2346
ISNE,"3/12/2020 12 a.m. EDT",10950,11080,8521,-2429
ISNE,"3/12/2020 1 a.m. EDT",10546,10260,8234,-2312
ISNE,"3/12/2020 2 a.m. EDT",10450,9960,8044,-2406
ISNE,"3/12/2020 3 a.m. EDT",10421,9850,7843,-2578
ISNE,"3/12/2020 4 a.m. EDT",10481,9910,7915,-2566
ISNE,"3/12/2020 5 a.m. EDT",10654,10280,8070,-2584
ISNE,"3/12/2020 6 a.m. EDT",11548,11280,8894,-2654
ISNE,"3/12/2020 7 a.m. EDT",12982,13020,9946,-3036
ISNE,"3/12/2020 8 a.m. EDT",13916,13920,10800,-3116
ISNE,"3/12/2020 9 a.m. EDT",13861,13850,10856,-3005
ISNE,"3/12/2020 10 a.m. EDT",13647,13650,10817,-2830
ISNE,"3/12/2020 11 a.m. EDT",13476,13380,10700,-2776
ISNE,"3/12/2020 12 p.m. EDT",13333,12950,10427,-2906
ISNE,"3/12/2020 1 p.m. EDT",13009,12700,10069,-2940
ISNE,"3/12/2020 2 p.m. EDT",12996,12670,9951,-3045
ISNE,"3/12/2020 3 p.m. EDT",12838,12740,9949,-2889
ISNE,"3/12/2020 4 p.m. EDT",12910,13030,10031,-2879
ISNE,"3/12/2020 5 p.m. EDT",13209,13250,10527,-2682
ISNE,"3/12/2020 6 p.m. EDT",13737,13440,10980,-2757
ISNE,"3/12/2020 7 p.m. EDT",14312,14110,11490,-2822
ISNE,"3/12/2020 8 p.m. EDT",14705,14330,11948,-2757
ISNE,"3/12/2020 9 p.m. EDT",14238,14090,11449,-2789
ISNE,"3/12/2020 10 p.m. EDT",13428,13250,10550,-2878
ISNE,"3/12/2020 11 p.m. EDT",12991,12060,10078,-2913
ISNE,"3/13/2020 12 a.m. EDT",12037,11030,9521,-2516
ISNE,"3/13/2020 1 a.m. EDT",11340,10530,9182,-2158
ISNE,"3/13/2020 2 a.m. EDT",11229,10130,8887,-2342
ISNE,"3/13/2020 3 a.m. EDT",11048,9950,8462,-2586
ISNE,"3/13/2020 4 a.m. EDT",11014,9940,8475,-2539
ISNE,"3/13/2020 5 a.m. EDT",11289,10220,8783,-2506
ISNE,"3/13/2020 6 a.m. EDT",12017,11060,9390,-2627
ISNE,"3/13/2020 7 a.m. EDT",12898,12480,10263,-2635
ISNE,"3/13/2020 8 a.m. EDT",13541,13560,10909,-2632
ISNE,"3/13/2020 9 a.m. EDT",14057,14040,11596,-2461
ISNE,"3/13/2020 10 a.m. EDT",14311,14170,11918,-2393
ISNE,"3/13/2020 11 a.m. EDT",14506,14530,12058,-2448
ISNE,"3/13/2020 12 p.m. EDT",14512,14240,12065,-2447
ISNE,"3/13/2020 1 p.m. EDT",14348,14010,11832,-2516
ISNE,"3/13/2020 2 p.m. EDT",14135,13740,11433,-2702
ISNE,"3/13/2020 3 p.m. EDT",13429,13270,10580,-2849
ISNE,"3/13/2020 4 p.m. EDT",12746,12850,10112,-2634
ISNE,"3/13/2020 5 p.m. EDT",12727,12520,10131,-2596
ISNE,"3/13/2020 6 p.m. EDT",13153,13010,10411,-2742
ISNE,"3/13/2020 7 p.m. EDT",13528,13450,10699,-2829
ISNE,"3/13/2020 8 p.m. EDT",13893,13840,11023,-2870
ISNE,"3/13/2020 9 p.m. EDT",13507,13590,10861,-2646
ISNE,"3/13/2020 10 p.m. EDT",12829,13010,10130,-2699
ISNE,"3/13/2020 11 p.m. EDT",12467,12240,9782,-2685
ISNE,"3/14/2020 12 a.m. EDT",11633,11370,9072,-2561
ISNE,"3/14/2020 1 a.m. EDT",10988,10410,8340,-2648
ISNE,"3/14/2020 2 a.m. EDT",10566,10000,7884,-2682
ISNE,"3/14/2020 3 a.m. EDT",10516,9780,7761,-2755
ISNE,"3/14/2020 4 a.m. EDT",10597,9740,7746,-2851
ISNE,"3/14/2020 5 a.m. EDT",10936,9920,8070,-2866
ISNE,"3/14/2020 6 a.m. EDT",10943,10410,7992,-2951
ISNE,"3/14/2020 7 a.m. EDT",11490,11010,8676,-2814
ISNE,"3/14/2020 8 a.m. EDT",11530,11610,9173,-2357
ISNE,"3/14/2020 9 a.m. EDT",11601,11710,9007,-2594
ISNE,"3/14/2020 10 a.m. EDT",11298,11390,9084,-2214
ISNE,"3/14/2020 11 a.m. EDT",10867,10770,8726,-2141
ISNE,"3/14/2020 12 p.m. EDT",10485,10400,8483,-2002
ISNE,"3/14/2020 1 p.m. EDT",10157,10210,8216,-1941
ISNE,"3/14/2020 2 p.m. EDT",10261,9860,8316,-1945
ISNE,"3/14/2020 3 p.m. EDT",10405,9790,8484,-1921
ISNE,"3/14/2020 4 p.m. EDT",10568,10180,8395,-2173
ISNE,"3/14/2020 5 p.m. EDT",11228,10940,8720,-2508
ISNE,"3/14/2020 6 p.m. EDT",12271,11820,9322,-2949
ISNE,"3/14/2020 7 p.m. EDT",13114,12750,10200,-2914
ISNE,"3/14/2020 8 p.m. EDT",13497,13140,10594,-2903
ISNE,"3/14/2020 9 p.m. EDT",13086,12900,10327,-2759
ISNE,"3/14/2020 10 p.m. EDT",12440,12410,9295,-3145
ISNE,"3/14/2020 11 p.m. EDT",11632,11730,8690,-2942
ISNE,"3/15/2020 12 a.m. EDT",10881,11010,8287,-2594
ISNE,"3/15/2020 1 a.m. EDT",10479,10360,7837,-2642
ISNE,"3/15/2020 2 a.m. EDT",10160,10000,7664,-2496
ISNE,"3/15/2020 3 a.m. EDT",9915,9820,7436,-2479
ISNE,"3/15/2020 4 a.m. EDT",9851,9770,7285,-2566
ISNE,"3/15/2020 5 a.m. EDT",9926,9850,7330,-2596
ISNE,"3/15/2020 6 a.m. EDT",10191,10130,7575,-2616
ISNE,"3/15/2020 7 a.m. EDT",10957,10660,8158,-2799
ISNE,"3/15/2020 8 a.m. EDT",11176,11240,8445,-2731
ISNE,"3/15/2020 9 a.m. EDT",11302,11160,8735,-2567
ISNE,"3/15/2020 10 a.m. EDT",11135,10910,8856,-2279
ISNE,"3/15/2020 11 a.m. EDT",10689,10390,8578,-2111
ISNE,"3/15/2020 12 p.m. EDT",10174,10110,8072,-2102
ISNE,"3/15/2020 1 p.m. EDT",9968,9910,8032,-1936
ISNE,"3/15/2020 2 p.m. EDT",9866,9660,7729,-2137
ISNE,"3/15/2020 3 p.m. EDT",9881,9580,7570,-2311
ISNE,"3/15/2020 4 p.m. EDT",9966,10020,7767,-2199
ISNE,"3/15/2020 5 p.m. EDT",10710,10950,8405,-2305
ISNE,"3/15/2020 6 p.m. EDT",11993,12120,9229,-2764
ISNE,"3/15/2020 7 p.m. EDT",13072,13160,10074,-2998
ISNE,"3/15/2020 8 p.m. EDT",13752,13880,10743,-3009
ISNE,"3/15/2020 9 p.m. EDT",13472,13620,10510,-2962
ISNE,"3/15/2020 10 p.m. EDT",12793,13050,9859,-2934
ISNE,"3/15/2020 11 p.m. EDT",11958,12160,8858,-3100
ISNE,"3/16/2020 12 a.m. EDT",11360,11230,8736,-2624
ISNE,"3/16/2020 1 a.m. EDT",10922,10730,8513,-2409
ISNE,"3/16/2020 2 a.m. EDT",10677,10490,8395,-2282
ISNE,"3/16/2020 3 a.m. EDT",10603,10430,8268,-2335
ISNE,"3/16/2020 4 a.m. EDT",10719,10570,8482,-2237
ISNE,"3/16/2020 5 a.m. EDT",11138,11000,8999,-2139
ISNE,"3/16/2020 6 a.m. EDT",11786,12080,9597,-2189
ISNE,"3/16/2020 7 a.m. EDT",13220,13650,11248,-1972
ISNE,"3/16/2020 8 a.m. EDT",14114,14580,11828,-2286
ISNE,"3/16/2020 9 a.m. EDT",13886,14140,11493,-2393
ISNE,"3/16/2020 10 a.m. EDT",13075,13020,10876,-2199
ISNE,"3/16/2020 11 a.m. EDT",12471,12480,10739,-1732
ISNE,"3/16/2020 12 p.m. EDT",12095,12070,10478,-1617
ISNE,"3/16/2020 1 p.m. EDT",11847,11820,10338,-1509
ISNE,"3/16/2020 2 p.m. EDT",11881,11680,9940,-1941
ISNE,"3/16/2020 3 p.m. EDT",11796,11800,9762,-2034
ISNE,"3/16/2020 4 p.m. EDT",12072,12280,9766,-2306
ISNE,"3/16/2020 5 p.m. EDT",12754,12980,10259,-2495
ISNE,"3/16/2020 6 p.m. EDT",13787,13870,10942,-2845
ISNE,"3/16/2020 7 p.m. EDT",14583,14530,11597,-2986
ISNE,"3/16/2020 8 p.m. EDT",15092,15010,11900,-3192
ISNE,"3/16/2020 9 p.m. EDT",14597,14580,11282,-3315
ISNE,"3/16/2020 10 p.m. EDT",13751,13700,10395,-3356
ISNE,"3/16/2020 11 p.m. EDT",12819,12560,9544,-3275
ISNE,"3/17/2020 12 a.m. EDT",11987,11550,9058,-2929
ISNE,"3/17/2020 1 a.m. EDT",11340,11130,8613,-2727
ISNE,"3/17/2020 2 a.m. EDT",11111,10770,8427,-2684
ISNE,"3/17/2020 3 a.m. EDT",11067,10600,8416,-2651
ISNE,"3/17/2020 4 a.m. EDT",11051,10610,8390,-2661
ISNE,"3/17/2020 5 a.m. EDT",11300,10900,8547,-2753
ISNE,"3/17/2020 6 a.m. EDT",11770,11790,8988,-2782
ISNE,"3/17/2020 7 a.m. EDT",12757,13230,9898,-2859
ISNE,"3/17/2020 8 a.m. EDT",13795,14190,10586,-3209
ISNE,"3/17/2020 9 a.m. EDT",14527,14550,11347,-3180
ISNE,"3/17/2020 10 a.m. EDT",14853,14860,12059,-2794
ISNE,"3/17/2020 11 a.m. EDT",15058,14920,12100,-2958
ISNE,"3/17/2020 12 p.m. EDT",15068,14720,11957,-3111
ISNE,"3/17/2020 1 p.m. EDT",14787,14520,11751,-3036
ISNE,"3/17/2020 2 p.m. EDT",14690,14360,11610,-3080
ISNE,"3/17/2020 3 p.m. EDT",14398,14020,11285,-3113
ISNE,"3/17/2020 4 p.m. EDT",13787,13780,10723,-3064
ISNE,"3/17/2020 5 p.m. EDT",13963,13750,10733,-3230
ISNE,"3/17/2020 6 p.m. EDT",14361,13950,10993,-3368
ISNE,"3/17/2020 7 p.m. EDT",14483,14420,11157,-3326
ISNE,"3/17/2020 8 p.m. EDT",14603,14750,11345,-3258
ISNE,"3/17/2020 9 p.m. EDT",14057,14370,10891,-3166
ISNE,"3/17/2020 10 p.m. EDT",13233,13460,9979,-3254
ISNE,"3/17/2020 11 p.m. EDT",12456,12260,9336,-3120
ISNE,"3/18/2020 12 a.m. EDT",11757,11240,9096,-2661
ISNE,"3/18/2020 1 a.m. EDT",11247,10680,8986,-2261
ISNE,"3/18/2020 2 a.m. EDT",10901,10350,8536,-2365
ISNE,"3/18/2020 3 a.m. EDT",10742,10230,8326,-2416
ISNE,"3/18/2020 4 a.m. EDT",10765,10240,8349,-2416
ISNE,"3/18/2020 5 a.m. EDT",11088,10560,9013,-2075
ISNE,"3/18/2020 6 a.m. EDT",11714,11450,9378,-2336
ISNE,"3/18/2020 7 a.m. EDT",12580,12950,9954,-2626
ISNE,"3/18/2020 8 a.m. EDT",13356,13520,10573,-2783
ISNE,"3/18/2020 9 a.m. EDT",13089,13080,10336,-2753
ISNE,"3/18/2020 10 a.m. EDT",12263,12230,10061,-2202
ISNE,"3/18/2020 11 a.m. EDT",11717,11590,9880,-1837
ISNE,"3/18/2020 12 p.m. EDT",11835,11040,9771,-2064
ISNE,"3/18/2020 1 p.m. EDT",11672,10780,9480,-2192
ISNE,"3/18/2020 2 p.m. EDT",11623,10710,9456,-2167
ISNE,"3/18/2020 3 p.m. EDT",11374,10770,9270,-2104
ISNE,"3/18/2020 4 p.m. EDT",11526,11200,9253,-2273
ISNE,"3/18/2020 5 p.m. EDT",12033,11940,9526,-2507
ISNE,"3/18/2020 6 p.m. EDT",13066,12880,10374,-2692
ISNE,"3/18/2020 7 p.m. EDT",13709,13540,10855,-2854
ISNE,"3/18/2020 8 p.m. EDT",14134,14120,11140,-2994
ISNE,"3/18/2020 9 p.m. EDT",13598,13890,10711,-2887
ISNE,"3/18/2020 10 p.m. EDT",12746,13110,9982,-2764
ISNE,"3/18/2020 11 p.m. EDT",11777,12060,9032,-2745
ISNE,"3/19/2020 12 a.m. EDT",11072,11110,8644,-2428
ISNE,"3/19/2020 1 a.m. EDT",10782,10270,8743,-2039
ISNE,"3/19/2020 2 a.m. EDT",10677,9930,8552,-2125
ISNE,"3/19/2020 3 a.m. EDT",10542,9760,8433,-2109
ISNE,"3/19/2020 4 a.m. EDT",10325,9770,8462,-1863
ISNE,"3/19/2020 5 a.m. EDT",10586,10070,8767,-1819
ISNE,"3/19/2020 6 a.m. EDT",11334,10820,9269,-2065
ISNE,"3/19/2020 7 a.m. EDT",11993,12030,9441,-2552
ISNE,"3/19/2020 8 a.m. EDT",13283,13090,10286,-2997
ISNE,"3/19/2020 9 a.m. EDT",13900,13830,10903,-2997
ISNE,"3/19/2020 10 a.m. EDT",14135,14240,11071,-3064
ISNE,"3/19/2020 11 a.m. EDT",14240,14310,11429,-2811
ISNE,"3/19/2020 12 p.m. EDT",14250,14170,11502,-2748
ISNE,"3/19/2020 1 p.m. EDT",14099,14050,11347,-2752
ISNE,"3/19/2020 2 p.m. EDT",13964,13980,11360,-2604
ISNE,"3/19/2020 3 p.m. EDT",13780,13800,11240,-2540
ISNE,"3/19/2020 4 p.m. EDT",13690,13790,11259,-2431
ISNE,"3/19/2020 5 p.m. EDT",13874,13930,11149,-2725
ISNE,"3/19/2020 6 p.m. EDT",14283,14180,11442,-2841
ISNE,"3/19/2020 7 p.m. EDT",14477,14400,11411,-3066
ISNE,"3/19/2020 8 p.m. EDT",14465,14640,11192,-3273
ISNE,"3/19/2020 9 p.m. EDT",13833,14210,10491,-3342
ISNE,"3/19/2020 10 p.m. EDT",12965,13320,9795,-3170
ISNE,"3/19/2020 11 p.m. EDT",12244,12200,9208,-3036
ISNE,"3/20/2020 12 a.m. EDT",11310,11200,8654,-2656
ISNE,"3/20/2020 1 a.m. EDT",10734,10390,8000,-2734
ISNE,"3/20/2020 2 a.m. EDT",10561,10020,8077,-2484
ISNE,"3/20/2020 3 a.m. EDT",10237,9830,7898,-2339
ISNE,"3/20/2020 4 a.m. EDT",10071,9760,7695,-2376
ISNE,"3/20/2020 5 a.m. EDT",10518,10010,7976,-2542
ISNE,"3/20/2020 6 a.m. EDT",10949,10690,8017,-2932
ISNE,"3/20/2020 7 a.m. EDT",11942,11800,8712,-3230
ISNE,"3/20/2020 8 a.m. EDT",12721,12730,9140,-3581
ISNE,"3/20/2020 9 a.m. EDT",13305,13300,9645,-3660
ISNE,"3/20/2020 10 a.m. EDT",13464,13490,9727,-3737
ISNE,"3/20/2020 11 a.m. EDT",13476,13350,9817,-3659
ISNE,"3/20/2020 12 p.m. EDT",13440,13100,9861,-3579
ISNE,"3/20/2020 1 p.m. EDT",13316,12760,9758,-3558
ISNE,"3/20/2020 2 p.m. EDT",12912,12680,9446,-3466
ISNE,"3/20/2020 3 p.m. EDT",12899,12500,9584,-3315
ISNE,"3/20/2020 4 p.m. EDT",12518,12540,9196,-3322
ISNE,"3/20/2020 5 p.m. EDT",12377,12640,9060,-3317
ISNE,"3/20/2020 6 p.m. EDT",12753,12950,9402,-3351
ISNE,"3/20/2020 7 p.m. EDT",13141,13240,9857,-3284
ISNE,"3/20/2020 8 p.m. EDT",13514,13500,10410,-3104
ISNE,"3/20/2020 9 p.m. EDT",13015,13010,9728,-3287
ISNE,"3/20/2020 10 p.m. EDT",12172,12260,9208,-2964
ISNE,"3/20/2020 11 p.m. EDT",12518,11390,9671,-2847
ISNE,"3/21/2020 12 a.m. EDT",10527,10500,8210,-2317
ISNE,"3/21/2020 1 a.m. EDT",9929,9620,7863,-2066
ISNE,"3/21/2020 2 a.m. EDT",9498,9240,7684,-1814
ISNE,"3/21/2020 3 a.m. EDT",9312,9040,7340,-1972
ISNE,"3/21/2020 4 a.m. EDT",9254,8990,7400,-1854
ISNE,"3/21/2020 5 a.m. EDT",9386,9130,7621,-1765
ISNE,"3/21/2020 6 a.m. EDT",9748,9490,7608,-2140
ISNE,"3/21/2020 7 a.m. EDT",10345,10110,7788,-2557
ISNE,"3/21/2020 8 a.m. EDT",10646,10650,8400,-2246
ISNE,"3/21/2020 9 a.m. EDT",11001,11000,8438,-2563
ISNE,"3/21/2020 10 a.m. EDT",10828,10800,8116,-2712
ISNE,"3/21/2020 11 a.m. EDT",10384,10350,7797,-2587
ISNE,"3/21/2020 12 p.m. EDT",10027,10000,7896,-2131
ISNE,"3/21/2020 1 p.m. EDT",9739,9720,8048,-1691
ISNE,"3/21/2020 2 p.m. EDT",9405,9400,7806,-1599
ISNE,"3/21/2020 3 p.m. EDT",9244,9230,7731,-1513
ISNE,"3/21/2020 4 p.m. EDT",9396,9500,7716,-1680
ISNE,"3/21/2020 5 p.m. EDT",10178,10100,8063,-2115
ISNE,"3/21/2020 6 p.m. EDT",11521,10780,9159,-2362
ISNE,"3/21/2020 7 p.m. EDT",12656,11760,9920,-2736
ISNE,"3/21/2020 8 p.m. EDT",13322,12870,10315,-3007
ISNE,"3/21/2020 9 p.m. EDT",13021,12710,10259,-2762
ISNE,"3/21/2020 10 p.m. EDT",12397,11960,9498,-2899
ISNE,"3/21/2020 11 p.m. EDT",11681,11480,8821,-2860
ISNE,"3/22/2020 12 a.m. EDT",10970,10940,8562,-2408
ISNE,"3/22/2020 1 a.m. EDT",10451,10440,8172,-2279
ISNE,"3/22/2020 2 a.m. EDT",10157,10140,8058,-2099
ISNE,"3/22/2020 3 a.m. EDT",10223,10030,8267,-1956
ISNE,"3/22/2020 4 a.m. EDT",10314,10020,8354,-1960
ISNE,"3/22/2020 5 a.m. EDT",10278,10150,8206,-2072
ISNE,"3/22/2020 6 a.m. EDT",10439,10450,8282,-2157
ISNE,"3/22/2020 7 a.m. EDT",10908,10910,8679,-2229
ISNE,"3/22/2020 8 a.m. EDT",11217,11220,8944,-2273
ISNE,"3/22/2020 9 a.m. EDT",11056,11060,8638,-2418
ISNE,"3/22/2020 10 a.m. EDT",10786,10620,8486,-2300
ISNE,"3/22/2020 11 a.m. EDT",10636,10240,8640,-1996
ISNE,"3/22/2020 12 p.m. EDT",10277,9910,8589,-1688
ISNE,"3/22/2020 1 p.m. EDT",10190,9710,8627,-1563
ISNE,"3/22/2020 2 p.m. EDT",9934,9510,8307,-1627
ISNE,"3/22/2020 3 p.m. EDT",10023,9720,8296,-1727
ISNE,"3/22/2020 4 p.m. EDT",10238,10330,8107,-2131
ISNE,"3/22/2020 5 p.m. EDT",11051,11220,8638,-2413
ISNE,"3/22/2020 6 p.m. EDT",12183,12380,9384,-2799
ISNE,"3/22/2020 7 p.m. EDT",13283,13280,10163,-3120
ISNE,"3/22/2020 8 p.m. EDT",14005,14200,10663,-3342
ISNE,"3/22/2020 9 p.m. EDT",13675,13830,10467,-3208
ISNE,"3/22/2020 10 p.m. EDT",12930,13050,9700,-3230
ISNE,"3/22/2020 11 p.m. EDT",12095,12140,8935,-3160
ISNE,"3/23/2020 12 a.m. EDT",11420,11310,8405,-3015
ISNE,"3/23/2020 1 a.m. EDT",11055,10730,8237,-2818
ISNE,"3/23/2020 2 a.m. EDT",10757,10450,7803,-2954
ISNE,"3/23/2020 3 a.m. EDT",10672,10360,7897,-2775
ISNE,"3/23/2020 4 a.m. EDT",10680,10380,7811,-2869
ISNE,"3/23/2020 5 a.m. EDT",10970,10680,8168,-2802
ISNE,"3/23/2020 6 a.m. EDT",11935,11450,9046,-2889
ISNE,"3/23/2020 7 a.m. EDT",12646,12630,10084,-2562
ISNE,"3/23/2020 8 a.m. EDT",13531,13540,11055,-2476
ISNE,"3/23/2020 9 a.m. EDT",13989,13980,11541,-2448
ISNE,"3/23/2020 10 a.m. EDT",14142,14150,11353,-2789
ISNE,"3/23/2020 11 a.m. EDT",14388,14150,11860,-2528
ISNE,"3/23/2020 12 p.m. EDT",14401,14170,11973,-2428
ISNE,"3/23/2020 1 p.m. EDT",14420,14090,11831,-2589
ISNE,"3/23/2020 2 p.m. EDT",14748,14060,12109,-2639
ISNE,"3/23/2020 3 p.m. EDT",14856,14110,11984,-2872
ISNE,"3/23/2020 4 p.m. EDT",14909,14140,11857,-3052
ISNE,"3/23/2020 5 p.m. EDT",15200,14430,12206,-2994
ISNE,"3/23/2020 6 p.m. EDT",15610,14950,12335,-3275
ISNE,"3/23/2020 7 p.m. EDT",15443,15270,12015,-3428
ISNE,"3/23/2020 8 p.m. EDT",15175,15580,11704,-3471
ISNE,"3/23/2020 9 p.m. EDT",14505,14790,11350,-3155
ISNE,"3/23/2020 10 p.m. EDT",13564,13710,10352,-3212
ISNE,"3/23/2020 11 p.m. EDT",12597,12670,9491,-3106
ISNE,"3/24/2020 12 a.m. EDT",11955,11650,9130,-2825
ISNE,"3/24/2020 1 a.m. EDT",11585,11050,9193,-2392
ISNE,"3/24/2020 2 a.m. EDT",11271,10670,8918,-2353
ISNE,"3/24/2020 3 a.m. EDT",11012,10480,8730,-2282
ISNE,"3/24/2020 4 a.m. EDT",10955,10420,8647,-2308
ISNE,"3/24/2020 5 a.m. EDT",11052,10650,8677,-2375
ISNE,"3/24/2020 6 a.m. EDT",11515,11290,9041,-2474
ISNE,"3/24/2020 7 a.m. EDT",12309,12340,9279,-3030
ISNE,"3/24/2020 8 a.m. EDT",13140,13150,9579,-3561
ISNE,"3/24/2020 9 a.m. EDT",13533,13520,10117,-3416
ISNE,"3/24/2020 10 a.m. EDT",13148,13160,10083,-3065
ISNE,"3/24/2020 11 a.m. EDT",12515,12460,9402,-3113
ISNE,"3/24/2020 12 p.m. EDT",12406,11950,9713,-2693
ISNE,"3/24/2020 1 p.m. EDT",12239,11700,9843,-2396
ISNE,"3/24/2020 2 p.m. EDT",12154,11600,9603,-2551
ISNE,"3/24/2020 3 p.m. EDT",12245,11610,9704,-2541
ISNE,"3/24/2020 4 p.m. EDT",12113,11810,9603,-2510
ISNE,"3/24/2020 5 p.m. EDT",12309,12270,9539,-2770
ISNE,"3/24/2020 6 p.m. EDT",13058,12900,9808,-3250
ISNE,"3/24/2020 7 p.m. EDT",13606,13580,10249,-3357
ISNE,"3/24/2020 8 p.m. EDT",14024,14400,10556,-3468
ISNE,"3/24/2020 9 p.m. EDT",13588,14080,10224,-3364
ISNE,"3/24/2020 10 p.m. EDT",12813,13150,9448,-3365
ISNE,"3/24/2020 11 p.m. EDT",11932,12140,8757,-3175
ISNE,"3/25/2020 12 a.m. EDT",11349,11260,8588,-2761
ISNE,"3/25/2020 1 a.m. EDT",11359,10540,8817,-2542
ISNE,"3/25/2020 2 a.m. EDT",11298,10240,8736,-2562
ISNE,"3/25/2020 3 a.m. EDT",11158,10090,8526,-2632
ISNE,"3/25/2020 4 a.m. EDT",11150,10080,8397,-2753
ISNE,"3/25/2020 5 a.m. EDT",11152,10320,8558,-2594
ISNE,"3/25/2020 6 a.m. EDT",11484,11000,8963,-2521
ISNE,"3/25/2020 7 a.m. EDT",12030,12060,9201,-2829
ISNE,"3/25/2020 8 a.m. EDT",12862,12870,9434,-3428
ISNE,"3/25/2020 9 a.m. EDT",13345,13350,9850,-3495
ISNE,"3/25/2020 10 a.m. EDT",13415,13440,10361,-3054
ISNE,"3/25/2020 11 a.m. EDT",13487,13260,10592,-2895
ISNE,"3/25/2020 12 p.m. EDT",13525,13090,10694,-2831
ISNE,"3/25/2020 1 p.m. EDT",13527,13020,10824,-2703
ISNE,"3/25/2020 2 p.m. EDT",13496,12970,10768,-2728
ISNE,"3/25/2020 3 p.m. EDT",13289,12920,10677,-2612
ISNE,"3/25/2020 4 p.m. EDT",13102,13020,10307,-2795
ISNE,"3/25/2020 5 p.m. EDT",13302,13370,10362,-2940
ISNE,"3/25/2020 6 p.m. EDT",13988,13870,10548,-3440
ISNE,"3/25/2020 7 p.m. EDT",14272,14440,10849,-3423
ISNE,"3/25/2020 8 p.m. EDT",14390,15000,10924,-3466
ISNE,"3/25/2020 9 p.m. EDT",13797,14330,10624,-3173
ISNE,"3/25/2020 10 p.m. EDT",12966,13500,10031,-2935
ISNE,"3/25/2020 11 p.m. EDT",12044,12390,9138,-2906
ISNE,"3/26/2020 12 a.m. EDT",11293,11420,8522,-2771
ISNE,"3/26/2020 1 a.m. EDT",10884,10700,8020,-2864
ISNE,"3/26/2020 2 a.m. EDT",10573,10400,7565,-3008
ISNE,"3/26/2020 3 a.m. EDT",10427,10250,7699,-2728
ISNE,"3/26/2020 4 a.m. EDT",10579,10270,7529,-3050
ISNE,"3/26/2020 5 a.m. EDT",10867,10590,7824,-3043
ISNE,"3/26/2020 6 a.m. EDT",11190,11490,8349,-2841
ISNE,"3/26/2020 7 a.m. EDT",12213,12890,9117,-3096
ISNE,"3/26/2020 8 a.m. EDT",12880,13520,9451,-3429
ISNE,"3/26/2020 9 a.m. EDT",12651,13230,9408,-3243
ISNE,"3/26/2020 10 a.m. EDT",11875,12030,8891,-2984
ISNE,"3/26/2020 11 a.m. EDT",11175,11290,8141,-3034
ISNE,"3/26/2020 12 p.m. EDT",10783,10850,7954,-2829
ISNE,"3/26/2020 1 p.m. EDT",10544,10500,7844,-2700
ISNE,"3/26/2020 2 p.m. EDT",10488,10440,7620,-2868
ISNE,"3/26/2020 3 p.m. EDT",10665,10480,7615,-3050
ISNE,"3/26/2020 4 p.m. EDT",10619,10980,7910,-2709
ISNE,"3/26/2020 5 p.m. EDT",11131,11590,8228,-2903
ISNE,"3/26/2020 6 p.m. EDT",12149,12640,8707,-3442
ISNE,"3/26/2020 7 p.m. EDT",12994,13490,9569,-3425
ISNE,"3/26/2020 8 p.m. EDT",13506,13970,10378,-3128
ISNE,"3/26/2020 9 p.m. EDT",13127,13740,10348,-2779
ISNE,"3/26/2020 10 p.m. EDT",12320,12970,9351,-2969
ISNE,"3/26/2020 11 p.m. EDT",11396,11890,8450,-2946
ISNE,"3/27/2020 12 a.m. EDT",10751,10950,7961,-2790
ISNE,"3/27/2020 1 a.m. EDT",10113,9930,7712,-2401
ISNE,"3/27/2020 2 a.m. EDT",9568,9550,7295,-2273
ISNE,"3/27/2020 3 a.m. EDT",9378,9370,7267,-2111
ISNE,"3/27/2020 4 a.m. EDT",9466,9310,7376,-2090
ISNE,"3/27/2020 5 a.m. EDT",9779,9530,7688,-2091
ISNE,"3/27/2020 6 a.m. EDT",10200,10130,7773,-2427
ISNE,"3/27/2020 7 a.m. EDT",11087,11120,8345,-2742
ISNE,"3/27/2020 8 a.m. EDT",11814,11820,8871,-2943
ISNE,"3/27/2020 9 a.m. EDT",11820,11800,8867,-2953
ISNE,"3/27/2020 10 a.m. EDT",11058,11000,8348,-2710
ISNE,"3/27/2020 11 a.m. EDT",10494,10400,7874,-2620
ISNE,"3/27/2020 12 p.m. EDT",10227,10120,8067,-2160
ISNE,"3/27/2020 1 p.m. EDT",10041,9720,7903,-2138
ISNE,"3/27/2020 2 p.m. EDT",9863,9620,8056,-1807
ISNE,"3/27/2020 3 p.m. EDT",9811,9670,8059,-1752
ISNE,"3/27/2020 4 p.m. EDT",9881,9830,8136,-1745
ISNE,"3/27/2020 5 p.m. EDT",10475,10310,8172,-2303
ISNE,"3/27/2020 6 p.m. EDT",11436,11180,9003,-2433
ISNE,"3/27/2020 7 p.m. EDT",12289,11920,9340,-2949
ISNE,"3/27/2020 8 p.m. EDT",12798,12490,9599,-3199
ISNE,"3/27/2020 9 p.m. EDT",12503,12300,9381,-3122
ISNE,"3/27/2020 10 p.m. EDT",11774,11710,9024,-2750
ISNE,"3/27/2020 11 p.m. EDT",10991,10990,8257,-2734
ISNE,"3/28/2020 12 a.m. EDT",10418,10210,7575,-2843
ISNE,"3/28/2020 1 a.m. EDT",9914,9650,7337,-2577
ISNE,"3/28/2020 2 a.m. EDT",9614,9340,7303,-2311
ISNE,"3/28/2020 3 a.m. EDT",9480,9220,7354,-2126
ISNE,"3/28/2020 4 a.m. EDT",9473,9220,7047,-2426
ISNE,"3/28/2020 5 a.m. EDT",9626,9380,7190,-2436
ISNE,"3/28/2020 6 a.m. EDT",9967,9740,7435,-2532
ISNE,"3/28/2020 7 a.m. EDT",10246,10270,7474,-2772
ISNE,"3/28/2020 8 a.m. EDT",10524,10540,7354,-3170
ISNE,"3/28/2020 9 a.m. EDT",10470,10470,7665,-2805
ISNE,"3/28/2020 10 a.m. EDT",10639,10360,7905,-2734
ISNE,"3/28/2020 11 a.m. EDT",10895,10470,8187,-2708
ISNE,"3/28/2020 12 p.m. EDT",10809,10470,7996,-2813
ISNE,"3/28/2020 1 p.m. EDT",11046,10450,8138,-2908
ISNE,"3/28/2020 2 p.m. EDT",11081,10600,7970,-3111
ISNE,"3/28/2020 3 p.m. EDT",11215,10800,8146,-3069
ISNE,"3/28/2020 4 p.m. EDT",11377,11030,8134,-3243
ISNE,"3/28/2020 5 p.m. EDT",12033,11420,8836,-3197
ISNE,"3/28/2020 6 p.m. EDT",12633,11870,9430,-3203
ISNE,"3/28/2020 7 p.m. EDT",12999,12300,9767,-3232
ISNE,"3/28/2020 8 p.m. EDT",13061,12400,9810,-3251
ISNE,"3/28/2020 9 p.m. EDT",12548,12180,9380,-3168
ISNE,"3/28/2020 10 p.m. EDT",11782,11720,8583,-3199
ISNE,"3/28/2020 11 p.m. EDT",11069,10990,7965,-3104
ISNE,"3/29/2020 12 a.m. EDT",10551,10260,7524,-3027
ISNE,"3/29/2020 1 a.m. EDT",10140,9670,7437,-2703
ISNE,"3/29/2020 2 a.m. EDT",9842,9300,7242,-2600
ISNE,"3/29/2020 3 a.m. EDT",9910,9110,7234,-2676
ISNE,"3/29/2020 4 a.m. EDT",9838,9020,7288,-2550
ISNE,"3/29/2020 5 a.m. EDT",9888,9050,7421,-2467
ISNE,"3/29/2020 6 a.m. EDT",10067,9260,7832,-2235
ISNE,"3/29/2020 7 a.m. EDT",10462,9660,7830,-2632
ISNE,"3/29/2020 8 a.m. EDT",10902,10140,8012,-2890
ISNE,"3/29/2020 9 a.m. EDT",11288,10860,8637,-2651
ISNE,"3/29/2020 10 a.m. EDT",11605,11620,9184,-2421
ISNE,"3/29/2020 11 a.m. EDT",12205,12220,9796,-2409
ISNE,"3/29/2020 12 p.m. EDT",12758,12850,10225,-2533
ISNE,"3/29/2020 1 p.m. EDT",13149,13050,10212,-2937
ISNE,"3/29/2020 2 p.m. EDT",13215,13040,10250,-2965
ISNE,"3/29/2020 3 p.m. EDT",13183,13000,10050,-3133
ISNE,"3/29/2020 4 p.m. EDT",13248,12950,10115,-3133
ISNE,"3/29/2020 5 p.m. EDT",13506,13190,10337,-3169
ISNE,"3/29/2020 6 p.m. EDT",13824,13390,10554,-3270
ISNE,"3/29/2020 7 p.m. EDT",13793,13670,10530,-3263
ISNE,"3/29/2020 8 p.m. EDT",13635,13880,10450,-3185
ISNE,"3/29/2020 9 p.m. EDT",13025,13480,9990,-3035
ISNE,"3/29/2020 10 p.m. EDT",12194,12390,9172,-3022
ISNE,"3/29/2020 11 p.m. EDT",11370,11220,8302,-3068
ISNE,"3/30/2020 12 a.m. EDT",10902,10380,8099,-2803
ISNE,"3/30/2020 1 a.m. EDT",10806,10150,8173,-2633
ISNE,"3/30/2020 2 a.m. EDT",10708,9850,8231,-2477
ISNE,"3/30/2020 3 a.m. EDT",10615,9650,8059,-2556
ISNE,"3/30/2020 4 a.m. EDT",10607,9570,7680,-2927
ISNE,"3/30/2020 5 a.m. EDT",10838,9820,7967,-2871
ISNE,"3/30/2020 6 a.m. EDT",11152,10630,8356,-2796
ISNE,"3/30/2020 7 a.m. EDT",11741,11800,8995,-2746
ISNE,"3/30/2020 8 a.m. EDT",12405,12610,9572,-2833
ISNE,"3/30/2020 9 a.m. EDT",13092,12990,10395,-2697
ISNE,"3/30/2020 10 a.m. EDT",13288,13160,10553,-2735
ISNE,"3/30/2020 11 a.m. EDT",13393,13030,10666,-2727
ISNE,"3/30/2020 12 p.m. EDT",13441,13060,10578,-2863
ISNE,"3/30/2020 1 p.m. EDT",13561,13540,10540,-3021
ISNE,"3/30/2020 2 p.m. EDT",13499,13450,10396,-3103
ISNE,"3/30/2020 3 p.m. EDT",13435,13360,10237,-3198
ISNE,"3/30/2020 4 p.m. EDT",13413,13360,10272,-3141
ISNE,"3/30/2020 5 p.m. EDT",13628,13450,10386,-3242
ISNE,"3/30/2020 6 p.m. EDT",14161,13700,10967,-3194
ISNE,"3/30/2020 7 p.m. EDT",14296,13960,10934,-3362
ISNE,"3/30/2020 8 p.m. EDT",14257,14390,11011,-3246
ISNE,"3/30/2020 9 p.m. EDT",13674,13880,10258,-3416
ISNE,"3/30/2020 10 p.m. EDT",12807,13140,9421,-3386
ISNE,"3/30/2020 11 p.m. EDT",12033,12170,8925,-3108
ISNE,"3/31/2020 12 a.m. EDT",11325,11280,8451,-2874
ISNE,"3/31/2020 1 a.m. EDT",10984,10490,8339,-2645
ISNE,"3/31/2020 2 a.m. EDT",10734,10140,8143,-2591
ISNE,"3/31/2020 3 a.m. EDT",10728,9960,8277,-2451
ISNE,"3/31/2020 4 a.m. EDT",10717,9910,7905,-2812
ISNE,"3/31/2020 5 a.m. EDT",10959,10190,8045,-2914
ISNE,"3/31/2020 6 a.m. EDT",11407,10900,8442,-2965
ISNE,"3/31/2020 7 a.m. EDT",12199,12000,8979,-3220
ISNE,"3/31/2020 8 a.m. EDT",12654,12730,9299,-3355
ISNE,"3/31/2020 9 a.m. EDT",12864,12970,9586,-3278
ISNE,"3/31/2020 10 a.m. EDT",12675,12800,9329,-3346
ISNE,"3/31/2020 11 a.m. EDT",12311,12380,9123,-3188
ISNE,"3/31/2020 12 p.m. EDT",11879,12060,8988,-2891
ISNE,"3/31/2020 1 p.m. EDT",11788,11830,9014,-2774
ISNE,"3/31/2020 2 p.m. EDT",11573,11690,8897,-2676
ISNE,"3/31/2020 3 p.m. EDT",11548,11630,8904,-2644
ISNE,"3/31/2020 4 p.m. EDT",11440,11810,8684,-2756
ISNE,"3/31/2020 5 p.m. EDT",11798,12180,8759,-3039
ISNE,"3/31/2020 6 p.m. EDT",12842,12900,9335,-3507
ISNE,"3/31/2020 7 p.m. EDT",13201,13560,9769,-3432
ISNE,"3/31/2020 8 p.m. EDT",13706,14000,10302,-3404
ISNE,"3/31/2020 9 p.m. EDT",13455,13690,10186,-3269
ISNE,"3/31/2020 10 p.m. EDT",12722,12950,9443,-3279
ISNE,"3/31/2020 11 p.m. EDT",11929,11970,8683,-3246
ISNE,"4/1/2020 12 a.m. EDT",11307,11120,8085,-3222
