"BA Code","Timestamp (Hour Ending)","Demand (MWh)","Demand Forecast (MWh)","Net Generation (MWh)","Total Interchange (MWh)"
ISNE,"3/1/2016 12 a.m. EST",12056,11880,9964,-2092
ISNE,"3/1/2016 1 a.m. EST",11918,11140,9685,-2233
ISNE,"3/1/2016 2 a.m. EST",11796,10800,9575,-2221
ISNE,"3/1/2016 3 a.m. EST",11696,10680,9558,-2138
ISNE,"3/1/2016 4 a.m. EST",11749,10760,9627,-2122
ISNE,"3/1/2016 5 a.m. EST",12186,10970,9969,-2217
ISNE,"3/1/2016 6 a.m. EST",12911,12170,10808,-2103
ISNE,"3/1/2016 7 a.m. EST",14155,13980,12294,-1861
ISNE,"3/1/2016 8 a.m. EST",14741,14820,13031,-1710
ISNE,"3/1/2016 9 a.m. EST",14550,14740,12871,-1679
ISNE,"3/1/2016 10 a.m. EST",14313,14440,12605,-1708
ISNE,"3/1/2016 11 a.m. EST",14335,14300,12738,-1597
ISNE,"3/1/2016 12 p.m. EST",14154,14140,12451,-1703
ISNE,"3/1/2016 1 p.m. EST",13874,14020,12097,-1777
ISNE,"3/1/2016 2 p.m. EST",13800,13890,11970,-1830
ISNE,"3/1/2016 3 p.m. EST",13711,13880,11854,-1857
ISNE,"3/1/2016 4 p.m. EST",13877,13990,11987,-1890
ISNE,"3/1/2016 5 p.m. EST",14405,14570,12547,-1858
ISNE,"3/1/2016 6 p.m. EST",15451,15720,13235,-2216
ISNE,"3/1/2016 7 p.m. EST",16367,16600,13894,-2473
ISNE,"3/1/2016 8 p.m. EST",16110,16340,13593,-2517
ISNE,"3/1/2016 9 p.m. EST",15544,15740,13430,-2114
ISNE,"3/1/2016 10 p.m. EST",14492,14740,12062,-2430
ISNE,"3/1/2016 11 p.m. EST",13205,13360,10800,-2405
ISNE,"3/2/2016 12 a.m. EST",12326,12250,10055,-2271
ISNE,"3/2/2016 1 a.m. EST",12032,11460,9796,-2236
ISNE,"3/2/2016 2 a.m. EST",11594,10970,9582,-2012
ISNE,"3/2/2016 3 a.m. EST",11383,10760,9423,-1960
ISNE,"3/2/2016 4 a.m. EST",10851,10730,8965,-1886
ISNE,"3/2/2016 5 a.m. EST",11188,10980,9194,-1994
ISNE,"3/2/2016 6 a.m. EST",12249,11940,9783,-2466
ISNE,"3/2/2016 7 a.m. EST",13563,13860,10983,-2580
ISNE,"3/2/2016 8 a.m. EST",14686,14830,11731,-2955
ISNE,"3/2/2016 9 a.m. EST",15008,15020,12037,-2971
ISNE,"3/2/2016 10 a.m. EST",14984,14940,11870,-3114
ISNE,"3/2/2016 11 a.m. EST",14898,14890,11513,-3385
ISNE,"3/2/2016 12 p.m. EST",14707,14750,11428,-3279
ISNE,"3/2/2016 1 p.m. EST",14537,14540,11350,-3187
ISNE,"3/2/2016 2 p.m. EST",14457,14500,11468,-2989
ISNE,"3/2/2016 3 p.m. EST",14479,14420,11301,-3178
ISNE,"3/2/2016 4 p.m. EST",14557,14620,11368,-3189
ISNE,"3/2/2016 5 p.m. EST",14928,15170,11806,-3122
ISNE,"3/2/2016 6 p.m. EST",16022,16400,12793,-3229
ISNE,"3/2/2016 7 p.m. EST",17045,17110,13699,-3346
ISNE,"3/2/2016 8 p.m. EST",16898,16880,13641,-3257
ISNE,"3/2/2016 9 p.m. EST",16403,16290,13386,-3017
ISNE,"3/2/2016 10 p.m. EST",15476,15380,12261,-3215
ISNE,"3/2/2016 11 p.m. EST",14208,14060,11077,-3131
ISNE,"3/3/2016 12 a.m. EST",13108,12940,10075,-3033
ISNE,"3/3/2016 1 a.m. EST",12882,12300,9543,-3339
ISNE,"3/3/2016 2 a.m. EST",12975,11930,9389,-3586
ISNE,"3/3/2016 3 a.m. EST",13073,11830,9464,-3609
ISNE,"3/3/2016 4 a.m. EST",13143,11890,9381,-3762
ISNE,"3/3/2016 5 a.m. EST",13340,12310,9752,-3588
ISNE,"3/3/2016 6 a.m. EST",13923,13630,10874,-3049
ISNE,"3/3/2016 7 a.m. EST",15398,15520,12244,-3154
ISNE,"3/3/2016 8 a.m. EST",16102,16130,12747,-3355
ISNE,"3/3/2016 9 a.m. EST",15866,15860,12218,-3648
ISNE,"3/3/2016 10 a.m. EST",15503,15380,11674,-3829
ISNE,"3/3/2016 11 a.m. EST",15281,14980,11316,-3965
ISNE,"3/3/2016 12 p.m. EST",15043,14700,11127,-3916
ISNE,"3/3/2016 1 p.m. EST",14778,14390,10831,-3947
ISNE,"3/3/2016 2 p.m. EST",14637,14300,10688,-3949
ISNE,"3/3/2016 3 p.m. EST",14560,14260,10746,-3814
ISNE,"3/3/2016 4 p.m. EST",14748,14520,11001,-3747
ISNE,"3/3/2016 5 p.m. EST",15377,15160,11463,-3914
ISNE,"3/3/2016 6 p.m. EST",16421,16470,12333,-4088
ISNE,"3/3/2016 7 p.m. EST",17276,17520,13246,-4030
ISNE,"3/3/2016 8 p.m. EST",17047,17310,12909,-4138
ISNE,"3/3/2016 9 p.m. EST",16567,16850,12328,-4239
ISNE,"3/3/2016 10 p.m. EST",15601,15890,11353,-4248
ISNE,"3/3/2016 11 p.m. EST",14359,14590,10371,-3988
ISNE,"3/4/2016 12 a.m. EST",13224,13500,9396,-3828
ISNE,"3/4/2016 1 a.m. EST",12572,12850,8774,-3798
ISNE,"3/4/2016 2 a.m. EST",12629,12370,9002,-3627
ISNE,"3/4/2016 3 a.m. EST",12473,12200,8784,-3689
ISNE,"3/4/2016 4 a.m. EST",12483,12270,8705,-3778
ISNE,"3/4/2016 5 a.m. EST",12815,12330,9166,-3649
ISNE,"3/4/2016 6 a.m. EST",13703,13440,10082,-3621
ISNE,"3/4/2016 7 a.m. EST",15039,15170,11420,-3619
ISNE,"3/4/2016 8 a.m. EST",15996,16160,12222,-3774
ISNE,"3/4/2016 9 a.m. EST",16272,16310,12822,-3450
ISNE,"3/4/2016 10 a.m. EST",16353,16150,12726,-3627
ISNE,"3/4/2016 11 a.m. EST",16315,16050,12436,-3879
ISNE,"3/4/2016 12 p.m. EST",16030,15790,12296,-3734
ISNE,"3/4/2016 1 p.m. EST",15722,15740,11771,-3951
ISNE,"3/4/2016 2 p.m. EST",15636,15790,11730,-3906
ISNE,"3/4/2016 3 p.m. EST",15554,15700,11529,-4025
ISNE,"3/4/2016 4 p.m. EST",15580,15800,11692,-3888
ISNE,"3/4/2016 5 p.m. EST",15915,16200,12110,-3805
ISNE,"3/4/2016 6 p.m. EST",16533,16860,12338,-4195
ISNE,"3/4/2016 7 p.m. EST",17014,17250,12728,-4286
ISNE,"3/4/2016 8 p.m. EST",16652,16870,12419,-4233
ISNE,"3/4/2016 9 p.m. EST",16139,16350,11933,-4206
ISNE,"3/4/2016 10 p.m. EST",15317,15550,11213,-4104
ISNE,"3/4/2016 11 p.m. EST",14254,14430,10440,-3814
ISNE,"3/5/2016 12 a.m. EST",13228,13310,9517,-3711
ISNE,"3/5/2016 1 a.m. EST",12452,12400,8886,-3566
ISNE,"3/5/2016 2 a.m. EST",12208,11930,9106,-3102
ISNE,"3/5/2016 3 a.m. EST",12203,11740,9113,-3090
ISNE,"3/5/2016 4 a.m. EST",12301,11670,9499,-2802
ISNE,"3/5/2016 5 a.m. EST",12228,11820,9495,-2733
ISNE,"3/5/2016 6 a.m. EST",12905,12350,10028,-2877
ISNE,"3/5/2016 7 a.m. EST",13265,12990,10168,-3097
ISNE,"3/5/2016 8 a.m. EST",13650,13570,10588,-3062
ISNE,"3/5/2016 9 a.m. EST",14070,14190,10925,-3145
ISNE,"3/5/2016 10 a.m. EST",14173,14400,10946,-3227
ISNE,"3/5/2016 11 a.m. EST",14070,14050,11078,-2992
ISNE,"3/5/2016 12 p.m. EST",13880,13770,11072,-2808
ISNE,"3/5/2016 1 p.m. EST",13637,13590,10754,-2883
ISNE,"3/5/2016 2 p.m. EST",13393,13330,10375,-3018
ISNE,"3/5/2016 3 p.m. EST",13542,13190,10662,-2880
ISNE,"3/5/2016 4 p.m. EST",13833,13290,10683,-3150
ISNE,"3/5/2016 5 p.m. EST",14346,13730,10964,-3382
ISNE,"3/5/2016 6 p.m. EST",14901,14780,11049,-3852
ISNE,"3/5/2016 7 p.m. EST",15666,15550,11799,-3867
ISNE,"3/5/2016 8 p.m. EST",15381,15470,11706,-3675
ISNE,"3/5/2016 9 p.m. EST",14943,15070,11268,-3675
ISNE,"3/5/2016 10 p.m. EST",14303,14420,10942,-3361
ISNE,"3/5/2016 11 p.m. EST",13446,13550,10522,-2924
ISNE,"3/6/2016 12 a.m. EST",12538,12690,9932,-2606
ISNE,"3/6/2016 1 a.m. EST",12112,11920,9317,-2795
ISNE,"3/6/2016 2 a.m. EST",11905,11540,9064,-2841
ISNE,"3/6/2016 3 a.m. EST",11771,11320,8940,-2831
ISNE,"3/6/2016 4 a.m. EST",11694,11180,8625,-3069
ISNE,"3/6/2016 5 a.m. EST",11795,11320,8579,-3216
ISNE,"3/6/2016 6 a.m. EST",11912,11580,8539,-3373
ISNE,"3/6/2016 7 a.m. EST",12330,11950,8855,-3475
ISNE,"3/6/2016 8 a.m. EST",12824,12410,9531,-3293
ISNE,"3/6/2016 9 a.m. EST",12950,13030,9948,-3002
ISNE,"3/6/2016 10 a.m. EST",13063,13350,10006,-3057
ISNE,"3/6/2016 11 a.m. EST",13025,13390,10320,-2705
ISNE,"3/6/2016 12 p.m. EST",12921,13170,10417,-2504
ISNE,"3/6/2016 1 p.m. EST",12795,13110,10127,-2668
ISNE,"3/6/2016 2 p.m. EST",12805,12940,10091,-2714
ISNE,"3/6/2016 3 p.m. EST",12774,12930,9965,-2809
ISNE,"3/6/2016 4 p.m. EST",12994,13100,10189,-2805
ISNE,"3/6/2016 5 p.m. EST",13673,13680,10874,-2799
ISNE,"3/6/2016 6 p.m. EST",14559,15030,11747,-2812
ISNE,"3/6/2016 7 p.m. EST",15677,15820,12731,-2946
ISNE,"3/6/2016 8 p.m. EST",15547,15670,12397,-3150
ISNE,"3/6/2016 9 p.m. EST",15059,15160,11954,-3105
ISNE,"3/6/2016 10 p.m. EST",14143,14230,11119,-3024
ISNE,"3/6/2016 11 p.m. EST",13069,13150,10321,-2748
ISNE,"3/7/2016 12 a.m. EST",12226,12190,9540,-2686
ISNE,"3/7/2016 1 a.m. EST",11968,11560,8936,-3032
ISNE,"3/7/2016 2 a.m. EST",12028,11260,8938,-3090
ISNE,"3/7/2016 3 a.m. EST",12155,11140,9214,-2941
ISNE,"3/7/2016 4 a.m. EST",12279,11200,9466,-2813
ISNE,"3/7/2016 5 a.m. EST",12487,11630,9713,-2774
ISNE,"3/7/2016 6 a.m. EST",12931,12780,9916,-3015
ISNE,"3/7/2016 7 a.m. EST",14401,14540,11723,-2678
ISNE,"3/7/2016 8 a.m. EST",15173,15410,12583,-2590
ISNE,"3/7/2016 9 a.m. EST",15251,15270,12294,-2957
ISNE,"3/7/2016 10 a.m. EST",15367,15070,12286,-3081
ISNE,"3/7/2016 11 a.m. EST",15319,14880,12365,-2954
ISNE,"3/7/2016 12 p.m. EST",15115,14730,12061,-3054
ISNE,"3/7/2016 1 p.m. EST",14770,14510,11718,-3052
ISNE,"3/7/2016 2 p.m. EST",14640,14410,11706,-2934
ISNE,"3/7/2016 3 p.m. EST",14669,14330,11954,-2715
ISNE,"3/7/2016 4 p.m. EST",14852,14410,12089,-2763
ISNE,"3/7/2016 5 p.m. EST",15195,14860,12277,-2918
ISNE,"3/7/2016 6 p.m. EST",15919,15820,12651,-3268
ISNE,"3/7/2016 7 p.m. EST",16489,16600,13442,-3047
ISNE,"3/7/2016 8 p.m. EST",16098,16340,13015,-3083
ISNE,"3/7/2016 9 p.m. EST",15385,15680,12290,-3095
ISNE,"3/7/2016 10 p.m. EST",14284,14570,11088,-3196
ISNE,"3/7/2016 11 p.m. EST",13132,13220,10198,-2934
ISNE,"3/8/2016 12 a.m. EST",12446,12070,10021,-2425
ISNE,"3/8/2016 1 a.m. EST",12352,11230,9900,-2452
ISNE,"3/8/2016 2 a.m. EST",12176,10870,9947,-2229
ISNE,"3/8/2016 3 a.m. EST",11999,10710,9821,-2178
ISNE,"3/8/2016 4 a.m. EST",12026,10720,9975,-2051
ISNE,"3/8/2016 5 a.m. EST",12428,11100,10107,-2321
ISNE,"3/8/2016 6 a.m. EST",13063,12170,10567,-2496
ISNE,"3/8/2016 7 a.m. EST",13951,13800,11399,-2552
ISNE,"3/8/2016 8 a.m. EST",14586,14530,12037,-2549
ISNE,"3/8/2016 9 a.m. EST",14359,14530,12053,-2306
ISNE,"3/8/2016 10 a.m. EST",14036,14410,11799,-2237
ISNE,"3/8/2016 11 a.m. EST",13879,14260,11769,-2110
ISNE,"3/8/2016 12 p.m. EST",13730,14130,11629,-2101
ISNE,"3/8/2016 1 p.m. EST",13550,13930,11603,-1947
ISNE,"3/8/2016 2 p.m. EST",13499,13840,11489,-2010
ISNE,"3/8/2016 3 p.m. EST",13384,13750,11114,-2270
ISNE,"3/8/2016 4 p.m. EST",13488,13800,11264,-2224
ISNE,"3/8/2016 5 p.m. EST",13946,14290,11794,-2152
ISNE,"3/8/2016 6 p.m. EST",14754,15210,12391,-2363
ISNE,"3/8/2016 7 p.m. EST",15757,15970,13514,-2243
ISNE,"3/8/2016 8 p.m. EST",15509,15700,13186,-2323
ISNE,"3/8/2016 9 p.m. EST",14904,15080,12562,-2342
ISNE,"3/8/2016 10 p.m. EST",13878,14040,11814,-2064
ISNE,"3/8/2016 11 p.m. EST",12592,12760,10866,-1726
ISNE,"3/9/2016 12 a.m. EST",11826,11630,9901,-1925
ISNE,"3/9/2016 1 a.m. EST",11492,10800,9549,-1943
ISNE,"3/9/2016 2 a.m. EST",11209,10420,9413,-1796
ISNE,"3/9/2016 3 a.m. EST",11242,10240,9343,-1899
ISNE,"3/9/2016 4 a.m. EST",11254,10240,9253,-2001
ISNE,"3/9/2016 5 a.m. EST",11582,10600,9344,-2238
ISNE,"3/9/2016 6 a.m. EST",12383,11710,10083,-2300
ISNE,"3/9/2016 7 a.m. EST",13270,13360,11460,-1810
ISNE,"3/9/2016 8 a.m. EST",14045,14170,12216,-1829
ISNE,"3/9/2016 9 a.m. EST",13888,14030,12076,-1812
ISNE,"3/9/2016 10 a.m. EST",13588,13790,11701,-1887
ISNE,"3/9/2016 11 a.m. EST",13493,13640,11590,-1903
ISNE,"3/9/2016 12 p.m. EST",13415,13570,11377,-2038
ISNE,"3/9/2016 1 p.m. EST",13357,13430,11237,-2120
ISNE,"3/9/2016 2 p.m. EST",13429,13450,11335,-2094
ISNE,"3/9/2016 3 p.m. EST",13463,13460,11382,-2081
ISNE,"3/9/2016 4 p.m. EST",13561,13540,11726,-1835
ISNE,"3/9/2016 5 p.m. EST",13879,13950,12183,-1696
ISNE,"3/9/2016 6 p.m. EST",14445,14720,12669,-1776
ISNE,"3/9/2016 7 p.m. EST",15302,15500,13537,-1765
ISNE,"3/9/2016 8 p.m. EST",15064,15150,13338,-1726
ISNE,"3/9/2016 9 p.m. EST",14387,14500,12750,-1637
ISNE,"3/9/2016 10 p.m. EST",13341,13450,11845,-1496
ISNE,"3/9/2016 11 p.m. EST",12035,12140,10630,-1405
ISNE,"3/10/2016 12 a.m. EST",11130,11040,9848,-1282
ISNE,"3/10/2016 1 a.m. EST",11070,10230,9477,-1593
ISNE,"3/10/2016 2 a.m. EST",11056,9910,9432,-1624
ISNE,"3/10/2016 3 a.m. EST",10765,9770,9508,-1257
ISNE,"3/10/2016 4 a.m. EST",10791,9720,9198,-1593
ISNE,"3/10/2016 5 a.m. EST",11070,10040,9325,-1745
ISNE,"3/10/2016 6 a.m. EST",11980,10860,10414,-1566
ISNE,"3/10/2016 7 a.m. EST",12630,12570,11489,-1141
ISNE,"3/10/2016 8 a.m. EST",13536,13470,11989,-1547
ISNE,"3/10/2016 9 a.m. EST",13897,13750,12274,-1623
ISNE,"3/10/2016 10 a.m. EST",14080,13800,12447,-1633
ISNE,"3/10/2016 11 a.m. EST",14221,13890,12409,-1812
ISNE,"3/10/2016 12 p.m. EST",14301,13920,12460,-1841
ISNE,"3/10/2016 1 p.m. EST",14321,13870,12505,-1816
ISNE,"3/10/2016 2 p.m. EST",14361,13910,12740,-1621
ISNE,"3/10/2016 3 p.m. EST",14241,13860,12615,-1626
ISNE,"3/10/2016 4 p.m. EST",14276,13900,12467,-1809
ISNE,"3/10/2016 5 p.m. EST",14537,14170,12795,-1742
ISNE,"3/10/2016 6 p.m. EST",15112,14850,13230,-1882
ISNE,"3/10/2016 7 p.m. EST",15532,15500,13584,-1948
ISNE,"3/10/2016 8 p.m. EST",15133,15100,13262,-1871
ISNE,"3/10/2016 9 p.m. EST",14461,14440,12761,-1700
ISNE,"3/10/2016 10 p.m. EST",13434,13390,11909,-1525
ISNE,"3/10/2016 11 p.m. EST",12150,12120,10720,-1430
ISNE,"3/11/2016 12 a.m. EST",11127,11020,9657,-1470
ISNE,"3/11/2016 1 a.m. EST",11418,10270,9384,-2034
ISNE,"3/11/2016 2 a.m. EST",11100,9820,9142,-1958
ISNE,"3/11/2016 3 a.m. EST",10854,9620,8898,-1956
ISNE,"3/11/2016 4 a.m. EST",10828,9580,8867,-1961
ISNE,"3/11/2016 5 a.m. EST",11110,9860,9298,-1812
ISNE,"3/11/2016 6 a.m. EST",11561,10870,9798,-1763
ISNE,"3/11/2016 7 a.m. EST",12717,12490,10957,-1760
ISNE,"3/11/2016 8 a.m. EST",13509,13290,11654,-1855
ISNE,"3/11/2016 9 a.m. EST",13688,13410,11876,-1812
ISNE,"3/11/2016 10 a.m. EST",13759,13330,12088,-1671
ISNE,"3/11/2016 11 a.m. EST",13768,13050,12072,-1696
ISNE,"3/11/2016 12 p.m. EST",13575,12780,11875,-1700
ISNE,"3/11/2016 1 p.m. EST",13248,12550,11578,-1670
ISNE,"3/11/2016 2 p.m. EST",13083,12510,11440,-1643
ISNE,"3/11/2016 3 p.m. EST",12973,12530,11342,-1631
ISNE,"3/11/2016 4 p.m. EST",12994,12680,11268,-1726
ISNE,"3/11/2016 5 p.m. EST",13323,13200,11780,-1543
ISNE,"3/11/2016 6 p.m. EST",13865,14100,12271,-1594
ISNE,"3/11/2016 7 p.m. EST",14656,14930,13108,-1548
ISNE,"3/11/2016 8 p.m. EST",14422,14600,12903,-1519
ISNE,"3/11/2016 9 p.m. EST",13924,14070,12205,-1719
ISNE,"3/11/2016 10 p.m. EST",13203,13380,11552,-1651
ISNE,"3/11/2016 11 p.m. EST",12242,12370,10770,-1472
ISNE,"3/12/2016 12 a.m. EST",11416,11400,9772,-1644
ISNE,"3/12/2016 1 a.m. EST",11115,10680,8955,-2160
ISNE,"3/12/2016 2 a.m. EST",10939,10230,8649,-2290
ISNE,"3/12/2016 3 a.m. EST",10777,10050,8892,-1885
ISNE,"3/12/2016 4 a.m. EST",10733,9990,8693,-2040
ISNE,"3/12/2016 5 a.m. EST",11003,10150,8803,-2200
ISNE,"3/12/2016 6 a.m. EST",11281,10600,9217,-2064
ISNE,"3/12/2016 7 a.m. EST",11718,11140,9813,-1905
ISNE,"3/12/2016 8 a.m. EST",12122,11590,10081,-2041
ISNE,"3/12/2016 9 a.m. EST",12250,11970,10418,-1832
ISNE,"3/12/2016 10 a.m. EST",12282,12060,10670,-1612
ISNE,"3/12/2016 11 a.m. EST",12250,11880,10870,-1380
ISNE,"3/12/2016 12 p.m. EST",12063,11640,10762,-1301
ISNE,"3/12/2016 1 p.m. EST",11801,11370,10407,-1394
ISNE,"3/12/2016 2 p.m. EST",11718,11160,10389,-1329
ISNE,"3/12/2016 3 p.m. EST",11872,11240,10479,-1393
ISNE,"3/12/2016 4 p.m. EST",12015,11540,10411,-1604
ISNE,"3/12/2016 5 p.m. EST",12424,12210,10612,-1812
ISNE,"3/12/2016 6 p.m. EST",12952,13190,11157,-1795
ISNE,"3/12/2016 7 p.m. EST",13872,14000,12243,-1629
ISNE,"3/12/2016 8 p.m. EST",13655,13690,11977,-1678
ISNE,"3/12/2016 9 p.m. EST",13201,13240,11463,-1738
ISNE,"3/12/2016 10 p.m. EST",12524,12590,10654,-1870
ISNE,"3/12/2016 11 p.m. EST",11816,11770,9934,-1882
ISNE,"3/13/2016 12 a.m. EST",11297,10920,9425,-1872
ISNE,"3/13/2016 1 a.m. EST",11116,10490,8930,-2186
ISNE,"3/13/2016 3 a.m. EDT",11059,9800,8960,-2099
ISNE,"3/13/2016 4 a.m. EDT",10851,9710,8811,-2040
ISNE,"3/13/2016 5 a.m. EDT",10806,9810,9034,-1772
ISNE,"3/13/2016 6 a.m. EDT",10959,9670,9246,-1713
ISNE,"3/13/2016 7 a.m. EDT",11360,10070,9915,-1445
ISNE,"3/13/2016 8 a.m. EDT",11539,10680,10121,-1418
ISNE,"3/13/2016 9 a.m. EDT",11461,11250,10004,-1457
ISNE,"3/13/2016 10 a.m. EDT",11577,11690,10229,-1348
ISNE,"3/13/2016 11 a.m. EDT",11750,11890,10516,-1234
ISNE,"3/13/2016 12 p.m. EDT",11638,12000,10568,-1070
ISNE,"3/13/2016 1 p.m. EDT",11532,11980,10439,-1093
ISNE,"3/13/2016 2 p.m. EDT",11412,11910,10287,-1125
ISNE,"3/13/2016 3 p.m. EDT",11296,11790,10233,-1063
ISNE,"3/13/2016 4 p.m. EDT",11404,11880,10229,-1175
ISNE,"3/13/2016 5 p.m. EDT",11813,12160,10633,-1180
ISNE,"3/13/2016 6 p.m. EDT",12484,12650,11044,-1440
ISNE,"3/13/2016 7 p.m. EDT",13211,13370,11431,-1780
ISNE,"3/13/2016 8 p.m. EDT",13990,14100,12321,-1669
ISNE,"3/13/2016 9 p.m. EDT",13673,13700,12020,-1653
ISNE,"3/13/2016 10 p.m. EDT",12809,12820,11227,-1582
ISNE,"3/13/2016 11 p.m. EDT",11711,11840,9907,-1804
ISNE,"3/14/2016 12 a.m. EDT",11295,10890,9607,-1688
ISNE,"3/14/2016 1 a.m. EDT",10737,10340,9194,-1543
ISNE,"3/14/2016 2 a.m. EDT",10329,10230,8874,-1455
ISNE,"3/14/2016 3 a.m. EDT",10388,10190,8973,-1415
ISNE,"3/14/2016 4 a.m. EDT",10460,10180,9206,-1254
ISNE,"3/14/2016 5 a.m. EDT",10545,10470,9515,-1030
ISNE,"3/14/2016 6 a.m. EDT",11166,10800,10224,-942
ISNE,"3/14/2016 7 a.m. EDT",12696,12830,11711,-985
ISNE,"3/14/2016 8 a.m. EDT",13946,13780,12297,-1649
ISNE,"3/14/2016 9 a.m. EDT",14314,13800,12633,-1681
ISNE,"3/14/2016 10 a.m. EDT",14543,13860,13022,-1521
ISNE,"3/14/2016 11 a.m. EDT",14781,13990,13370,-1411
ISNE,"3/14/2016 12 p.m. EDT",14897,14100,13418,-1479
ISNE,"3/14/2016 1 p.m. EDT",14901,14180,13260,-1641
ISNE,"3/14/2016 2 p.m. EDT",14897,14240,13264,-1633
ISNE,"3/14/2016 3 p.m. EDT",14772,14200,13400,-1372
ISNE,"3/14/2016 4 p.m. EDT",14778,14410,13342,-1436
ISNE,"3/14/2016 5 p.m. EDT",15019,14770,13570,-1449
ISNE,"3/14/2016 6 p.m. EDT",15483,15260,13979,-1504
ISNE,"3/14/2016 7 p.m. EDT",15854,15780,14022,-1832
ISNE,"3/14/2016 8 p.m. EDT",16065,16140,14271,-1794
ISNE,"3/14/2016 9 p.m. EDT",15487,15400,13995,-1492
ISNE,"3/14/2016 10 p.m. EDT",14428,14290,12834,-1594
ISNE,"3/14/2016 11 p.m. EDT",13102,12970,11627,-1475
ISNE,"3/15/2016 12 a.m. EDT",11874,11730,10377,-1497
ISNE,"3/15/2016 1 a.m. EDT",11460,10970,9814,-1646
ISNE,"3/15/2016 2 a.m. EDT",11274,10530,9594,-1680
ISNE,"3/15/2016 3 a.m. EDT",11227,10360,9551,-1676
ISNE,"3/15/2016 4 a.m. EDT",11166,10340,9580,-1586
ISNE,"3/15/2016 5 a.m. EDT",11257,10660,9652,-1605
ISNE,"3/15/2016 6 a.m. EDT",12092,11670,10343,-1749
ISNE,"3/15/2016 7 a.m. EDT",13414,13730,11885,-1529
ISNE,"3/15/2016 8 a.m. EDT",14601,14710,13084,-1517
ISNE,"3/15/2016 9 a.m. EDT",14875,14770,13452,-1423
ISNE,"3/15/2016 10 a.m. EDT",14971,14650,13393,-1578
ISNE,"3/15/2016 11 a.m. EDT",15032,14700,13382,-1650
ISNE,"3/15/2016 12 p.m. EDT",14956,14640,13101,-1855
ISNE,"3/15/2016 1 p.m. EDT",14747,14630,12769,-1978
ISNE,"3/15/2016 2 p.m. EDT",14679,14600,12582,-2097
ISNE,"3/15/2016 3 p.m. EDT",14505,14480,12628,-1877
ISNE,"3/15/2016 4 p.m. EDT",14430,14560,12918,-1512
ISNE,"3/15/2016 5 p.m. EDT",14835,14730,12941,-1894
ISNE,"3/15/2016 6 p.m. EDT",15039,15070,13068,-1971
ISNE,"3/15/2016 7 p.m. EDT",15267,15420,13205,-2062
ISNE,"3/15/2016 8 p.m. EDT",15555,15900,13448,-2107
ISNE,"3/15/2016 9 p.m. EDT",15114,15430,13160,-1954
ISNE,"3/15/2016 10 p.m. EDT",14145,14420,12132,-2013
ISNE,"3/15/2016 11 p.m. EDT",13000,13050,10854,-2146
ISNE,"3/16/2016 12 a.m. EDT",11960,11770,10040,-1920
ISNE,"3/16/2016 1 a.m. EDT",11234,11050,9433,-1801
ISNE,"3/16/2016 2 a.m. EDT",11197,10620,9572,-1625
ISNE,"3/16/2016 3 a.m. EDT",11178,10420,9530,-1648
ISNE,"3/16/2016 4 a.m. EDT",11212,10110,9648,-1564
ISNE,"3/16/2016 5 a.m. EDT",11368,10430,9846,-1522
ISNE,"3/16/2016 6 a.m. EDT",11906,11480,10403,-1503
ISNE,"3/16/2016 7 a.m. EDT",13431,13340,11608,-1823
ISNE,"3/16/2016 8 a.m. EDT",14301,14410,12222,-2079
ISNE,"3/16/2016 9 a.m. EDT",14434,14510,12338,-2096
ISNE,"3/16/2016 10 a.m. EDT",14344,14370,12523,-1821
ISNE,"3/16/2016 11 a.m. EDT",14254,14280,12198,-2056
ISNE,"3/16/2016 12 p.m. EDT",14033,14130,11994,-2039
ISNE,"3/16/2016 1 p.m. EDT",13742,13940,11653,-2089
ISNE,"3/16/2016 2 p.m. EDT",13601,13860,11739,-1862
ISNE,"3/16/2016 3 p.m. EDT",13381,13740,11565,-1816
ISNE,"3/16/2016 4 p.m. EDT",13341,13750,11752,-1589
ISNE,"3/16/2016 5 p.m. EDT",13503,14030,11921,-1582
ISNE,"3/16/2016 6 p.m. EDT",13849,14490,12062,-1787
ISNE,"3/16/2016 7 p.m. EDT",14412,14860,12375,-2037
ISNE,"3/16/2016 8 p.m. EDT",15043,15350,13133,-1910
ISNE,"3/16/2016 9 p.m. EDT",14661,14910,12827,-1834
ISNE,"3/16/2016 10 p.m. EDT",13751,13970,11806,-1945
ISNE,"3/16/2016 11 p.m. EDT",12460,12690,10808,-1652
ISNE,"3/17/2016 12 a.m. EDT",11622,11470,10208,-1414
ISNE,"3/17/2016 1 a.m. EDT",11304,10540,9096,-2208
ISNE,"3/17/2016 2 a.m. EDT",10906,10060,8763,-2143
ISNE,"3/17/2016 3 a.m. EDT",10947,9880,8802,-2145
ISNE,"3/17/2016 4 a.m. EDT",10885,9870,8935,-1950
ISNE,"3/17/2016 5 a.m. EDT",11022,10130,9010,-2012
ISNE,"3/17/2016 6 a.m. EDT",11858,11090,9816,-2042
ISNE,"3/17/2016 7 a.m. EDT",13132,12840,11442,-1690
ISNE,"3/17/2016 8 a.m. EDT",14031,13760,11979,-2052
ISNE,"3/17/2016 9 a.m. EDT",14191,13890,12479,-1712
ISNE,"3/17/2016 10 a.m. EDT",14046,13740,12486,-1560
ISNE,"3/17/2016 11 a.m. EDT",13681,13610,12207,-1474
ISNE,"3/17/2016 12 p.m. EDT",13412,13400,11884,-1528
ISNE,"3/17/2016 1 p.m. EDT",13318,13190,11910,-1408
ISNE,"3/17/2016 2 p.m. EDT",13461,13150,12206,-1255
ISNE,"3/17/2016 3 p.m. EDT",13445,13050,12371,-1074
ISNE,"3/17/2016 4 p.m. EDT",13371,13090,12362,-1009
ISNE,"3/17/2016 5 p.m. EDT",13633,13390,12511,-1122
ISNE,"3/17/2016 6 p.m. EDT",13915,14020,12606,-1309
ISNE,"3/17/2016 7 p.m. EDT",14232,14400,12826,-1406
ISNE,"3/17/2016 8 p.m. EDT",14688,15000,13181,-1507
ISNE,"3/17/2016 9 p.m. EDT",14429,14580,12934,-1495
ISNE,"3/17/2016 10 p.m. EDT",13564,13730,12116,-1448
ISNE,"3/17/2016 11 p.m. EDT",12368,12470,10750,-1618
ISNE,"3/18/2016 12 a.m. EDT",11691,11290,9692,-1999
ISNE,"3/18/2016 1 a.m. EDT",11341,10470,9320,-2021
ISNE,"3/18/2016 2 a.m. EDT",11372,10040,9376,-1996
ISNE,"3/18/2016 3 a.m. EDT",11300,9840,9282,-2018
ISNE,"3/18/2016 4 a.m. EDT",11278,9820,9182,-2096
ISNE,"3/18/2016 5 a.m. EDT",11547,10200,9488,-2059
ISNE,"3/18/2016 6 a.m. EDT",11851,11030,9996,-1855
ISNE,"3/18/2016 7 a.m. EDT",13000,12800,11276,-1724
ISNE,"3/18/2016 8 a.m. EDT",13985,13860,12047,-1938
ISNE,"3/18/2016 9 a.m. EDT",14010,14030,12126,-1884
ISNE,"3/18/2016 10 a.m. EDT",13884,13890,12137,-1747
ISNE,"3/18/2016 11 a.m. EDT",13890,13690,12213,-1677
ISNE,"3/18/2016 12 p.m. EDT",13794,13560,12132,-1662
ISNE,"3/18/2016 1 p.m. EDT",13713,13500,12243,-1470
ISNE,"3/18/2016 2 p.m. EDT",13631,13520,12185,-1446
ISNE,"3/18/2016 3 p.m. EDT",13535,13540,11746,-1789
ISNE,"3/18/2016 4 p.m. EDT",13416,13500,11736,-1680
ISNE,"3/18/2016 5 p.m. EDT",13477,13610,11764,-1713
ISNE,"3/18/2016 6 p.m. EDT",13707,13880,11999,-1708
ISNE,"3/18/2016 7 p.m. EDT",14006,14150,12222,-1784
ISNE,"3/18/2016 8 p.m. EDT",14589,14700,12634,-1955
ISNE,"3/18/2016 9 p.m. EDT",14413,14390,12434,-1979
ISNE,"3/18/2016 10 p.m. EDT",13768,13740,11685,-2083
ISNE,"3/18/2016 11 p.m. EDT",12834,12780,10969,-1865
ISNE,"3/19/2016 12 a.m. EDT",11877,11790,10062,-1815
ISNE,"3/19/2016 1 a.m. EDT",11715,10960,9515,-2200
ISNE,"3/19/2016 2 a.m. EDT",11999,10580,9778,-2221
ISNE,"3/19/2016 3 a.m. EDT",11812,10360,9509,-2303
ISNE,"3/19/2016 4 a.m. EDT",11546,10350,9342,-2204
ISNE,"3/19/2016 5 a.m. EDT",11642,10460,9866,-1776
ISNE,"3/19/2016 6 a.m. EDT",12077,10900,10018,-2059
ISNE,"3/19/2016 7 a.m. EDT",12858,11650,10612,-2246
ISNE,"3/19/2016 8 a.m. EDT",12894,12440,10820,-2074
ISNE,"3/19/2016 9 a.m. EDT",13071,12990,11041,-2030
ISNE,"3/19/2016 10 a.m. EDT",13241,13320,11236,-2005
ISNE,"3/19/2016 11 a.m. EDT",13125,13140,11119,-2006
ISNE,"3/19/2016 12 p.m. EDT",12870,12820,10761,-2109
ISNE,"3/19/2016 1 p.m. EDT",12558,12520,10274,-2284
ISNE,"3/19/2016 2 p.m. EDT",12274,12200,10181,-2093
ISNE,"3/19/2016 3 p.m. EDT",12199,12010,10054,-2145
ISNE,"3/19/2016 4 p.m. EDT",12160,11970,10037,-2123
ISNE,"3/19/2016 5 p.m. EDT",12329,12360,10203,-2126
ISNE,"3/19/2016 6 p.m. EDT",12696,13030,10617,-2079
ISNE,"3/19/2016 7 p.m. EDT",13275,13510,11163,-2112
ISNE,"3/19/2016 8 p.m. EDT",14076,14270,12085,-1991
ISNE,"3/19/2016 9 p.m. EDT",14045,14020,12046,-1999
ISNE,"3/19/2016 10 p.m. EDT",13550,13540,11583,-1967
ISNE,"3/19/2016 11 p.m. EDT",12780,12820,10484,-2296
ISNE,"3/20/2016 12 a.m. EDT",11989,11910,9790,-2199
ISNE,"3/20/2016 1 a.m. EDT",11921,11400,9401,-2520
ISNE,"3/20/2016 2 a.m. EDT",11620,11020,9179,-2441
ISNE,"3/20/2016 3 a.m. EDT",11431,10840,8814,-2617
ISNE,"3/20/2016 4 a.m. EDT",11393,10800,8772,-2621
ISNE,"3/20/2016 5 a.m. EDT",11272,10900,8831,-2441
ISNE,"3/20/2016 6 a.m. EDT",11516,11060,9028,-2488
ISNE,"3/20/2016 7 a.m. EDT",12072,11500,9770,-2302
ISNE,"3/20/2016 8 a.m. EDT",12170,12060,10277,-1893
ISNE,"3/20/2016 9 a.m. EDT",12592,12740,10889,-1703
ISNE,"3/20/2016 10 a.m. EDT",12815,13120,11166,-1649
ISNE,"3/20/2016 11 a.m. EDT",12823,13190,11206,-1617
ISNE,"3/20/2016 12 p.m. EDT",12829,13150,11231,-1598
ISNE,"3/20/2016 1 p.m. EDT",12800,13040,11173,-1627
ISNE,"3/20/2016 2 p.m. EDT",12716,12820,11104,-1612
ISNE,"3/20/2016 3 p.m. EDT",12649,12590,10901,-1748
ISNE,"3/20/2016 4 p.m. EDT",12803,12600,11048,-1755
ISNE,"3/20/2016 5 p.m. EDT",13062,12830,11315,-1747
ISNE,"3/20/2016 6 p.m. EDT",13692,13290,11900,-1792
ISNE,"3/20/2016 7 p.m. EDT",14338,13980,12284,-2054
ISNE,"3/20/2016 8 p.m. EDT",15040,14910,12818,-2222
ISNE,"3/20/2016 9 p.m. EDT",14737,14770,12413,-2324
ISNE,"3/20/2016 10 p.m. EDT",13850,13870,11926,-1924
ISNE,"3/20/2016 11 p.m. EDT",12728,12770,10753,-1975
ISNE,"3/21/2016 12 a.m. EDT",12240,11770,10032,-2208
ISNE,"3/21/2016 1 a.m. EDT",12133,11030,9814,-2319
ISNE,"3/21/2016 2 a.m. EDT",11915,10710,9465,-2450
ISNE,"3/21/2016 3 a.m. EDT",11611,10600,9368,-2243
ISNE,"3/21/2016 4 a.m. EDT",11598,10670,9073,-2525
ISNE,"3/21/2016 5 a.m. EDT",11953,11070,9526,-2427
ISNE,"3/21/2016 6 a.m. EDT",12510,12180,10249,-2261
ISNE,"3/21/2016 7 a.m. EDT",13683,14110,11599,-2084
ISNE,"3/21/2016 8 a.m. EDT",14806,15190,12780,-2026
ISNE,"3/21/2016 9 a.m. EDT",15514,15370,13190,-2324
ISNE,"3/21/2016 10 a.m. EDT",15718,15340,13462,-2256
ISNE,"3/21/2016 11 a.m. EDT",15717,15360,13346,-2371
ISNE,"3/21/2016 12 p.m. EDT",15504,15170,12970,-2534
ISNE,"3/21/2016 1 p.m. EDT",15094,14860,12263,-2831
ISNE,"3/21/2016 2 p.m. EDT",14776,14620,12085,-2691
ISNE,"3/21/2016 3 p.m. EDT",14442,14380,11733,-2709
ISNE,"3/21/2016 4 p.m. EDT",14078,14260,11520,-2558
ISNE,"3/21/2016 5 p.m. EDT",14131,14370,11464,-2667
ISNE,"3/21/2016 6 p.m. EDT",14609,14690,11884,-2725
ISNE,"3/21/2016 7 p.m. EDT",15063,15310,12244,-2819
ISNE,"3/21/2016 8 p.m. EDT",15774,16120,13081,-2693
ISNE,"3/21/2016 9 p.m. EDT",15551,15890,12748,-2803
ISNE,"3/21/2016 10 p.m. EDT",14594,14850,12092,-2502
ISNE,"3/21/2016 11 p.m. EDT",13294,13640,11098,-2196
ISNE,"3/22/2016 12 a.m. EDT",12638,12490,10085,-2553
ISNE,"3/22/2016 1 a.m. EDT",12002,11430,9428,-2574
ISNE,"3/22/2016 2 a.m. EDT",11804,11070,9073,-2731
ISNE,"3/22/2016 3 a.m. EDT",11857,10930,9024,-2833
ISNE,"3/22/2016 4 a.m. EDT",12022,10980,9219,-2803
ISNE,"3/22/2016 5 a.m. EDT",11976,11340,9471,-2505
ISNE,"3/22/2016 6 a.m. EDT",12565,12370,10188,-2377
ISNE,"3/22/2016 7 a.m. EDT",14296,14060,12303,-1993
ISNE,"3/22/2016 8 a.m. EDT",15247,15000,13147,-2100
ISNE,"3/22/2016 9 a.m. EDT",15091,15180,13020,-2071
ISNE,"3/22/2016 10 a.m. EDT",14748,14780,12747,-2001
ISNE,"3/22/2016 11 a.m. EDT",14452,14500,12414,-2038
ISNE,"3/22/2016 12 p.m. EDT",14157,14240,12235,-1922
ISNE,"3/22/2016 1 p.m. EDT",14026,13980,11975,-2051
ISNE,"3/22/2016 2 p.m. EDT",13932,13850,11876,-2056
ISNE,"3/22/2016 3 p.m. EDT",13661,13700,11507,-2154
ISNE,"3/22/2016 4 p.m. EDT",13577,13700,11488,-2089
ISNE,"3/22/2016 5 p.m. EDT",13696,13840,11580,-2116
ISNE,"3/22/2016 6 p.m. EDT",14140,14190,11814,-2326
ISNE,"3/22/2016 7 p.m. EDT",14674,14780,12228,-2446
ISNE,"3/22/2016 8 p.m. EDT",15414,15500,12674,-2740
ISNE,"3/22/2016 9 p.m. EDT",15212,15240,12551,-2661
ISNE,"3/22/2016 10 p.m. EDT",14280,14240,11560,-2720
ISNE,"3/22/2016 11 p.m. EDT",12948,12930,10159,-2789
ISNE,"3/23/2016 12 a.m. EDT",12014,11810,9743,-2271
ISNE,"3/23/2016 1 a.m. EDT",11744,11010,9489,-2255
ISNE,"3/23/2016 2 a.m. EDT",11316,10600,9250,-2066
ISNE,"3/23/2016 3 a.m. EDT",11115,10400,9369,-1746
ISNE,"3/23/2016 4 a.m. EDT",11287,10390,9416,-1871
ISNE,"3/23/2016 5 a.m. EDT",11336,10480,9390,-1946
ISNE,"3/23/2016 6 a.m. EDT",11882,11500,9820,-2062
ISNE,"3/23/2016 7 a.m. EDT",13340,13420,11088,-2252
ISNE,"3/23/2016 8 a.m. EDT",14442,14470,12091,-2351
ISNE,"3/23/2016 9 a.m. EDT",14679,14440,12031,-2648
ISNE,"3/23/2016 10 a.m. EDT",14707,14340,12070,-2637
ISNE,"3/23/2016 11 a.m. EDT",14562,14200,12081,-2481
ISNE,"3/23/2016 12 p.m. EDT",14346,13890,12078,-2268
ISNE,"3/23/2016 1 p.m. EDT",13979,13690,11758,-2221
ISNE,"3/23/2016 2 p.m. EDT",13794,13550,11569,-2225
ISNE,"3/23/2016 3 p.m. EDT",13655,13400,11672,-1983
ISNE,"3/23/2016 4 p.m. EDT",13533,13280,11380,-2153
ISNE,"3/23/2016 5 p.m. EDT",13780,13310,11536,-2244
ISNE,"3/23/2016 6 p.m. EDT",14275,13500,12405,-1870
ISNE,"3/23/2016 7 p.m. EDT",14609,14090,12618,-1991
ISNE,"3/23/2016 8 p.m. EDT",15037,14880,12730,-2307
ISNE,"3/23/2016 9 p.m. EDT",14711,14620,12266,-2445
ISNE,"3/23/2016 10 p.m. EDT",13762,13680,11363,-2399
ISNE,"3/23/2016 11 p.m. EDT",12465,12440,10208,-2257
ISNE,"3/24/2016 12 a.m. EDT",11528,11310,9512,-2016
ISNE,"3/24/2016 1 a.m. EDT",11550,10660,9164,-2386
ISNE,"3/24/2016 2 a.m. EDT",11390,10290,9127,-2263
ISNE,"3/24/2016 3 a.m. EDT",11355,10110,9210,-2145
ISNE,"3/24/2016 4 a.m. EDT",11353,10120,9132,-2221
ISNE,"3/24/2016 5 a.m. EDT",11682,10370,9382,-2300
ISNE,"3/24/2016 6 a.m. EDT",12446,11440,10173,-2273
ISNE,"3/24/2016 7 a.m. EDT",13291,13330,11346,-1945
ISNE,"3/24/2016 8 a.m. EDT",14340,14480,12122,-2218
ISNE,"3/24/2016 9 a.m. EDT",14448,14730,12278,-2170
ISNE,"3/24/2016 10 a.m. EDT",14336,14690,12235,-2101
ISNE,"3/24/2016 11 a.m. EDT",14265,14730,12171,-2094
ISNE,"3/24/2016 12 p.m. EDT",14226,14580,12194,-2032
ISNE,"3/24/2016 1 p.m. EDT",14129,14310,12110,-2019
ISNE,"3/24/2016 2 p.m. EDT",14163,14250,12154,-2009
ISNE,"3/24/2016 3 p.m. EDT",14113,14140,11946,-2167
ISNE,"3/24/2016 4 p.m. EDT",14081,14140,12018,-2063
ISNE,"3/24/2016 5 p.m. EDT",14284,14320,12045,-2239
ISNE,"3/24/2016 6 p.m. EDT",14663,14720,12448,-2215
ISNE,"3/24/2016 7 p.m. EDT",15035,15090,12768,-2267
ISNE,"3/24/2016 8 p.m. EDT",15451,15300,13113,-2338
ISNE,"3/24/2016 9 p.m. EDT",15125,15200,12963,-2162
ISNE,"3/24/2016 10 p.m. EDT",14260,14260,12415,-1845
ISNE,"3/24/2016 11 p.m. EDT",13043,12940,11106,-1937
ISNE,"3/25/2016 12 a.m. EDT",11883,11750,9822,-2061
ISNE,"3/25/2016 1 a.m. EDT",11522,10950,9420,-2102
ISNE,"3/25/2016 2 a.m. EDT",11479,10340,9435,-2044
ISNE,"3/25/2016 3 a.m. EDT",11474,10010,9366,-2108
ISNE,"3/25/2016 4 a.m. EDT",11391,9920,9389,-2002
ISNE,"3/25/2016 5 a.m. EDT",11372,10410,9266,-2106
ISNE,"3/25/2016 6 a.m. EDT",11617,11050,9466,-2151
ISNE,"3/25/2016 7 a.m. EDT",12655,12060,10563,-2092
ISNE,"3/25/2016 8 a.m. EDT",13726,12830,11453,-2273
ISNE,"3/25/2016 9 a.m. EDT",14398,13270,11964,-2434
ISNE,"3/25/2016 10 a.m. EDT",14816,13600,12354,-2462
ISNE,"3/25/2016 11 a.m. EDT",15033,13600,12448,-2585
ISNE,"3/25/2016 12 p.m. EDT",15002,13440,12357,-2645
ISNE,"3/25/2016 1 p.m. EDT",14777,13210,11880,-2897
ISNE,"3/25/2016 2 p.m. EDT",14559,13060,11538,-3021
ISNE,"3/25/2016 3 p.m. EDT",14202,12840,11633,-2569
ISNE,"3/25/2016 4 p.m. EDT",13881,12720,11509,-2372
ISNE,"3/25/2016 5 p.m. EDT",13887,12790,11546,-2341
ISNE,"3/25/2016 6 p.m. EDT",14122,13050,11640,-2482
ISNE,"3/25/2016 7 p.m. EDT",14232,13290,11469,-2763
ISNE,"3/25/2016 8 p.m. EDT",14426,14000,11888,-2538
ISNE,"3/25/2016 9 p.m. EDT",14113,13640,11992,-2121
ISNE,"3/25/2016 10 p.m. EDT",13400,12980,11348,-2052
ISNE,"3/25/2016 11 p.m. EDT",12458,12060,10394,-2064
ISNE,"3/26/2016 12 a.m. EDT",11600,11120,9528,-2072
ISNE,"3/26/2016 1 a.m. EDT",11281,10630,9389,-1892
ISNE,"3/26/2016 2 a.m. EDT",11156,10220,9266,-1890
ISNE,"3/26/2016 3 a.m. EDT",11191,10040,9117,-2074
ISNE,"3/26/2016 4 a.m. EDT",11121,9980,8824,-2297
ISNE,"3/26/2016 5 a.m. EDT",11225,10110,8972,-2253
ISNE,"3/26/2016 6 a.m. EDT",11490,10460,9252,-2238
ISNE,"3/26/2016 7 a.m. EDT",11804,11030,9631,-2173
ISNE,"3/26/2016 8 a.m. EDT",12251,11630,9974,-2277
ISNE,"3/26/2016 9 a.m. EDT",12864,12250,10696,-2168
ISNE,"3/26/2016 10 a.m. EDT",13363,12430,11200,-2163
ISNE,"3/26/2016 11 a.m. EDT",13386,12250,11247,-2139
ISNE,"3/26/2016 12 p.m. EDT",13216,11990,10979,-2237
ISNE,"3/26/2016 1 p.m. EDT",12942,11690,10829,-2113
ISNE,"3/26/2016 2 p.m. EDT",12519,11370,10399,-2120
ISNE,"3/26/2016 3 p.m. EDT",12011,11240,10140,-1871
ISNE,"3/26/2016 4 p.m. EDT",11929,11310,10064,-1865
ISNE,"3/26/2016 5 p.m. EDT",12158,11640,9778,-2380
ISNE,"3/26/2016 6 p.m. EDT",12406,12260,10182,-2224
ISNE,"3/26/2016 7 p.m. EDT",12961,12910,10551,-2410
ISNE,"3/26/2016 8 p.m. EDT",13753,13660,11166,-2587
ISNE,"3/26/2016 9 p.m. EDT",13852,13590,11450,-2402
ISNE,"3/26/2016 10 p.m. EDT",13341,13020,11046,-2295
ISNE,"3/26/2016 11 p.m. EDT",12536,12220,10339,-2197
ISNE,"3/27/2016 12 a.m. EDT",11802,11300,9572,-2230
ISNE,"3/27/2016 1 a.m. EDT",11829,10660,9219,-2610
ISNE,"3/27/2016 2 a.m. EDT",11450,10250,9002,-2448
ISNE,"3/27/2016 3 a.m. EDT",11198,10060,8888,-2310
ISNE,"3/27/2016 4 a.m. EDT",11187,10030,8781,-2406
ISNE,"3/27/2016 5 a.m. EDT",11237,10130,8880,-2357
ISNE,"3/27/2016 6 a.m. EDT",11347,10460,8923,-2424
ISNE,"3/27/2016 7 a.m. EDT",11626,10910,9164,-2462
ISNE,"3/27/2016 8 a.m. EDT",12142,11520,9533,-2609
ISNE,"3/27/2016 9 a.m. EDT",12586,12250,10180,-2406
ISNE,"3/27/2016 10 a.m. EDT",13101,12630,10746,-2355
ISNE,"3/27/2016 11 a.m. EDT",13227,12730,10857,-2370
ISNE,"3/27/2016 12 p.m. EDT",12909,12690,10627,-2282
ISNE,"3/27/2016 1 p.m. EDT",12291,12540,10210,-2081
ISNE,"3/27/2016 2 p.m. EDT",11526,12280,9638,-1888
ISNE,"3/27/2016 3 p.m. EDT",11208,12020,9426,-1782
ISNE,"3/27/2016 4 p.m. EDT",11316,11990,9574,-1742
ISNE,"3/27/2016 5 p.m. EDT",11495,12280,9773,-1722
ISNE,"3/27/2016 6 p.m. EDT",11527,12880,9634,-1893
ISNE,"3/27/2016 7 p.m. EDT",12181,13410,10067,-2114
ISNE,"3/27/2016 8 p.m. EDT",13320,14150,11097,-2223
ISNE,"3/27/2016 9 p.m. EDT",13568,14000,11318,-2250
ISNE,"3/27/2016 10 p.m. EDT",12924,13220,10670,-2254
ISNE,"3/27/2016 11 p.m. EDT",11926,12170,9929,-1997
ISNE,"3/28/2016 12 a.m. EDT",11085,11180,9113,-1972
ISNE,"3/28/2016 1 a.m. EDT",11094,10410,8628,-2466
ISNE,"3/28/2016 2 a.m. EDT",10813,10090,8309,-2504
ISNE,"3/28/2016 3 a.m. EDT",10876,9980,8338,-2538
ISNE,"3/28/2016 4 a.m. EDT",10949,10040,8415,-2534
ISNE,"3/28/2016 5 a.m. EDT",11352,10430,8804,-2548
ISNE,"3/28/2016 6 a.m. EDT",12173,11430,9817,-2356
ISNE,"3/28/2016 7 a.m. EDT",13208,13450,10834,-2374
ISNE,"3/28/2016 8 a.m. EDT",14385,14700,11811,-2574
ISNE,"3/28/2016 9 a.m. EDT",14911,14940,12358,-2553
ISNE,"3/28/2016 10 a.m. EDT",15191,14990,12710,-2481
ISNE,"3/28/2016 11 a.m. EDT",15410,15070,12932,-2478
ISNE,"3/28/2016 12 p.m. EDT",15494,15000,12931,-2563
ISNE,"3/28/2016 1 p.m. EDT",15403,14880,12683,-2720
ISNE,"3/28/2016 2 p.m. EDT",15257,14780,12503,-2754
ISNE,"3/28/2016 3 p.m. EDT",14964,14580,12405,-2559
ISNE,"3/28/2016 4 p.m. EDT",14809,14460,12379,-2430
ISNE,"3/28/2016 5 p.m. EDT",14811,14600,12382,-2429
ISNE,"3/28/2016 6 p.m. EDT",15044,14940,12492,-2552
ISNE,"3/28/2016 7 p.m. EDT",15217,15260,12421,-2796
ISNE,"3/28/2016 8 p.m. EDT",15543,15650,12617,-2926
ISNE,"3/28/2016 9 p.m. EDT",15184,15220,12486,-2698
ISNE,"3/28/2016 10 p.m. EDT",14140,14190,11866,-2274
ISNE,"3/28/2016 11 p.m. EDT",12918,12830,10629,-2289
ISNE,"3/29/2016 12 a.m. EDT",11861,11630,9459,-2402
ISNE,"3/29/2016 1 a.m. EDT",11738,10840,9089,-2649
ISNE,"3/29/2016 2 a.m. EDT",11705,10440,8873,-2832
ISNE,"3/29/2016 3 a.m. EDT",11610,10280,8706,-2904
ISNE,"3/29/2016 4 a.m. EDT",11603,10290,8751,-2852
ISNE,"3/29/2016 5 a.m. EDT",11925,10630,9176,-2749
ISNE,"3/29/2016 6 a.m. EDT",12537,11670,9921,-2616
ISNE,"3/29/2016 7 a.m. EDT",13518,13530,11094,-2424
ISNE,"3/29/2016 8 a.m. EDT",14480,14460,11955,-2525
ISNE,"3/29/2016 9 a.m. EDT",14549,14420,12317,-2232
ISNE,"3/29/2016 10 a.m. EDT",14361,14240,12089,-2272
ISNE,"3/29/2016 11 a.m. EDT",14209,14070,11877,-2332
ISNE,"3/29/2016 12 p.m. EDT",13940,13880,11600,-2340
ISNE,"3/29/2016 1 p.m. EDT",13661,13790,11417,-2244
ISNE,"3/29/2016 2 p.m. EDT",13765,13590,11582,-2183
ISNE,"3/29/2016 3 p.m. EDT",13555,13430,11192,-2363
ISNE,"3/29/2016 4 p.m. EDT",13454,13390,10989,-2465
ISNE,"3/29/2016 5 p.m. EDT",13405,13690,10855,-2550
ISNE,"3/29/2016 6 p.m. EDT",13905,14220,11408,-2497
ISNE,"3/29/2016 7 p.m. EDT",14439,14790,11681,-2758
ISNE,"3/29/2016 8 p.m. EDT",15206,15570,12350,-2856
ISNE,"3/29/2016 9 p.m. EDT",15210,15310,12496,-2714
ISNE,"3/29/2016 10 p.m. EDT",14297,14390,12010,-2287
ISNE,"3/29/2016 11 p.m. EDT",12981,13100,10646,-2335
ISNE,"3/30/2016 12 a.m. EDT",11960,11950,9538,-2422
ISNE,"3/30/2016 1 a.m. EDT",11745,11200,8836,-2909
ISNE,"3/30/2016 2 a.m. EDT",11767,10810,8704,-3063
ISNE,"3/30/2016 3 a.m. EDT",11603,10680,8620,-2983
ISNE,"3/30/2016 4 a.m. EDT",11876,10730,8720,-3156
ISNE,"3/30/2016 5 a.m. EDT",12025,11080,9027,-2998
ISNE,"3/30/2016 6 a.m. EDT",12453,12160,9538,-2915
ISNE,"3/30/2016 7 a.m. EDT",13907,14070,11364,-2543
ISNE,"3/30/2016 8 a.m. EDT",14785,14930,12047,-2738
ISNE,"3/30/2016 9 a.m. EDT",14530,14530,11840,-2690
ISNE,"3/30/2016 10 a.m. EDT",14113,14110,11272,-2841
ISNE,"3/30/2016 11 a.m. EDT",13761,13790,10838,-2923
ISNE,"3/30/2016 12 p.m. EDT",13482,13370,10558,-2924
ISNE,"3/30/2016 1 p.m. EDT",13187,13170,10446,-2741
ISNE,"3/30/2016 2 p.m. EDT",13079,13020,10345,-2734
ISNE,"3/30/2016 3 p.m. EDT",13131,12910,10406,-2725
ISNE,"3/30/2016 4 p.m. EDT",13073,12880,10418,-2655
ISNE,"3/30/2016 5 p.m. EDT",13115,13190,10579,-2536
ISNE,"3/30/2016 6 p.m. EDT",13560,13760,11074,-2486
ISNE,"3/30/2016 7 p.m. EDT",14045,14330,11400,-2645
ISNE,"3/30/2016 8 p.m. EDT",14844,15070,12184,-2660
ISNE,"3/30/2016 9 p.m. EDT",14782,14910,12065,-2717
ISNE,"3/30/2016 10 p.m. EDT",13870,13970,11357,-2513
ISNE,"3/30/2016 11 p.m. EDT",12606,12680,9936,-2670
ISNE,"3/31/2016 12 a.m. EDT",11893,11520,9215,-2678
ISNE,"3/31/2016 1 a.m. EDT",11434,10730,8967,-2467
ISNE,"3/31/2016 2 a.m. EDT",11308,10300,8726,-2582
ISNE,"3/31/2016 3 a.m. EDT",11200,10120,8873,-2327
ISNE,"3/31/2016 4 a.m. EDT",11277,10110,8834,-2443
ISNE,"3/31/2016 5 a.m. EDT",11447,10420,8806,-2641
ISNE,"3/31/2016 6 a.m. EDT",11812,11400,9388,-2424
ISNE,"3/31/2016 7 a.m. EDT",13093,13150,11449,-1644
ISNE,"3/31/2016 8 a.m. EDT",13941,14170,12349,-1592
ISNE,"3/31/2016 9 a.m. EDT",13855,14030,12619,-1236
ISNE,"3/31/2016 10 a.m. EDT",13681,13780,12364,-1317
ISNE,"3/31/2016 11 a.m. EDT",13628,13590,11973,-1655
ISNE,"3/31/2016 12 p.m. EDT",13587,13320,12043,-1544
ISNE,"3/31/2016 1 p.m. EDT",13390,13170,11769,-1621
ISNE,"3/31/2016 2 p.m. EDT",13324,13150,11983,-1341
ISNE,"3/31/2016 3 p.m. EDT",13232,13160,11824,-1408
ISNE,"3/31/2016 4 p.m. EDT",13151,13190,11257,-1894
ISNE,"3/31/2016 5 p.m. EDT",13345,13370,10808,-2537
ISNE,"3/31/2016 6 p.m. EDT",13642,13720,10722,-2920
ISNE,"3/31/2016 7 p.m. EDT",13876,14060,10940,-2936
ISNE,"3/31/2016 8 p.m. EDT",14520,14640,11595,-2925
ISNE,"3/31/2016 9 p.m. EDT",14345,14560,11907,-2438
ISNE,"3/31/2016 10 p.m. EDT",13438,13520,11357,-2081
ISNE,"3/31/2016 11 p.m. EDT",12165,12210,10253,-1912
ISNE,"4/1/2016 12 a.m. EDT",11461,11050,9699,-1762
