"BA Code","Timestamp (Hour Ending)","Demand (MWh)","Demand Forecast (MWh)","Net Generation (MWh)","Total Interchange (MWh)"
BANC,"6/1/2017 12 a.m. PDT",1841,1810,1435,-406
BANC,"6/1/2017 1 a.m. PDT",1754,1685,1269,-485
BANC,"6/1/2017 2 a.m. PDT",1677,1607,1181,-496
BANC,"6/1/2017 3 a.m. PDT",1609,1545,1220,-389
BANC,"6/1/2017 4 a.m. PDT",1593,1525,1231,-362
BANC,"6/1/2017 5 a.m. PDT",1607,1544,1209,-398
BANC,"6/1/2017 6 a.m. PDT",1701,1628,1451,-250
BANC,"6/1/2017 7 a.m. PDT",1768,1738,1538,-230
BANC,"6/1/2017 8 a.m. PDT",1872,1797,1602,-270
BANC,"6/1/2017 9 a.m. PDT",1943,1853,1603,-340
BANC,"6/1/2017 10 a.m. PDT",2015,1886,1471,-544
BANC,"6/1/2017 11 a.m. PDT",2110,1957,1514,-596
BANC,"6/1/2017 12 p.m. PDT",2184,2050,1591,-593
BANC,"6/1/2017 1 p.m. PDT",2290,2126,1633,-657
BANC,"6/1/2017 2 p.m. PDT",2410,2217,1751,-659
BANC,"6/1/2017 3 p.m. PDT",2522,2309,1760,-762
BANC,"6/1/2017 4 p.m. PDT",2650,2387,1938,-712
BANC,"6/1/2017 5 p.m. PDT",2778,2457,2007,-771
BANC,"6/1/2017 6 p.m. PDT",2843,2505,2213,-630
BANC,"6/1/2017 7 p.m. PDT",2797,2455,2165,-632
BANC,"6/1/2017 8 p.m. PDT",2673,2384,2140,-533
BANC,"6/1/2017 9 p.m. PDT",2553,2347,2103,-450
BANC,"6/1/2017 10 p.m. PDT",2431,2288,2069,-362
BANC,"6/1/2017 11 p.m. PDT",2202,2069,1902,-300
BANC,"6/2/2017 12 a.m. PDT",1993,1869,1773,-220
BANC,"6/2/2017 1 a.m. PDT",1806,1789,1562,-244
BANC,"6/2/2017 2 a.m. PDT",1710,1685,1476,-234
BANC,"6/2/2017 3 a.m. PDT",1650,1614,1341,-309
BANC,"6/2/2017 4 a.m. PDT",1625,1590,1316,-309
BANC,"6/2/2017 5 a.m. PDT",1653,1603,1474,-179
BANC,"6/2/2017 6 a.m. PDT",1714,1680,1645,-69
BANC,"6/2/2017 7 a.m. PDT",1782,1793,1619,-163
BANC,"6/2/2017 8 a.m. PDT",1884,1863,1487,-397
BANC,"6/2/2017 9 a.m. PDT",1965,1943,1436,-529
BANC,"6/2/2017 10 a.m. PDT",2080,2021,1391,-689
BANC,"6/2/2017 11 a.m. PDT",2182,2118,1447,-735
BANC,"6/2/2017 12 p.m. PDT",2291,2221,1580,-711
BANC,"6/2/2017 1 p.m. PDT",2441,2329,1638,-803
BANC,"6/2/2017 2 p.m. PDT",2614,2483,1767,-847
BANC,"6/2/2017 3 p.m. PDT",2795,2628,1881,-914
BANC,"6/2/2017 4 p.m. PDT",2938,2778,1975,-963
BANC,"6/2/2017 5 p.m. PDT",3080,2886,2120,-960
BANC,"6/2/2017 6 p.m. PDT",3142,2953,2155,-987
BANC,"6/2/2017 7 p.m. PDT",3090,2891,2121,-969
BANC,"6/2/2017 8 p.m. PDT",2968,2767,2130,-838
BANC,"6/2/2017 9 p.m. PDT",2793,2683,2049,-744
BANC,"6/2/2017 10 p.m. PDT",2648,2542,2036,-612
BANC,"6/2/2017 11 p.m. PDT",2410,2283,2065,-345
BANC,"6/3/2017 12 a.m. PDT",2137,2029,1862,-275
BANC,"6/3/2017 1 a.m. PDT",1945,1817,1606,-339
BANC,"6/3/2017 2 a.m. PDT",1800,1699,1481,-319
BANC,"6/3/2017 3 a.m. PDT",1716,1614,1367,-349
BANC,"6/3/2017 4 a.m. PDT",1661,1566,1388,-273
BANC,"6/3/2017 5 a.m. PDT",1643,1551,1450,-193
BANC,"6/3/2017 6 a.m. PDT",1665,1553,1592,-73
BANC,"6/3/2017 7 a.m. PDT",1646,1559,1564,-82
BANC,"6/3/2017 8 a.m. PDT",1680,1604,1374,-306
BANC,"6/3/2017 9 a.m. PDT",1770,1721,1423,-347
BANC,"6/3/2017 10 a.m. PDT",1862,1825,1493,-369
BANC,"6/3/2017 11 a.m. PDT",1993,1939,1495,-498
BANC,"6/3/2017 12 p.m. PDT",2110,2045,1590,-520
BANC,"6/3/2017 1 p.m. PDT",2239,2156,1574,-665
BANC,"6/3/2017 2 p.m. PDT",2306,2296,1638,-668
BANC,"6/3/2017 3 p.m. PDT",2467,2436,1673,-794
BANC,"6/3/2017 4 p.m. PDT",2660,2577,1918,-742
BANC,"6/3/2017 5 p.m. PDT",2819,2675,2057,-762
BANC,"6/3/2017 6 p.m. PDT",2897,2740,2077,-820
BANC,"6/3/2017 7 p.m. PDT",2890,2706,2048,-842
BANC,"6/3/2017 8 p.m. PDT",2770,2600,2151,-619
BANC,"6/3/2017 9 p.m. PDT",2611,2508,2087,-524
BANC,"6/3/2017 10 p.m. PDT",2463,2401,2078,-385
BANC,"6/3/2017 11 p.m. PDT",2227,2181,1865,-362
BANC,"6/4/2017 12 a.m. PDT",1993,1969,1700,-293
BANC,"6/4/2017 1 a.m. PDT",1828,1776,1589,-239
BANC,"6/4/2017 2 a.m. PDT",1694,1653,1395,-299
BANC,"6/4/2017 3 a.m. PDT",1607,1580,1207,-400
BANC,"6/4/2017 4 a.m. PDT",1578,1532,1311,-267
BANC,"6/4/2017 5 a.m. PDT",1588,1527,1593,5
BANC,"6/4/2017 6 a.m. PDT",1563,1525,1427,-136
BANC,"6/4/2017 7 a.m. PDT",1554,1525,1428,-126
BANC,"6/4/2017 8 a.m. PDT",1585,1579,1302,-283
BANC,"6/4/2017 9 a.m. PDT",1662,1691,1300,-362
BANC,"6/4/2017 10 a.m. PDT",1742,1796,1303,-439
BANC,"6/4/2017 11 a.m. PDT",1816,1900,1279,-537
BANC,"6/4/2017 12 p.m. PDT",1925,2008,1447,-478
BANC,"6/4/2017 1 p.m. PDT",2036,2142,1676,-360
BANC,"6/4/2017 2 p.m. PDT",2183,2273,1832,-351
BANC,"6/4/2017 3 p.m. PDT",2359,2447,1984,-375
BANC,"6/4/2017 4 p.m. PDT",2547,2624,2169,-378
BANC,"6/4/2017 5 p.m. PDT",2689,2767,2092,-597
BANC,"6/4/2017 6 p.m. PDT",2775,2865,2127,-648
BANC,"6/4/2017 7 p.m. PDT",2722,2864,2161,-561
BANC,"6/4/2017 8 p.m. PDT",2586,2746,2108,-478
BANC,"6/4/2017 9 p.m. PDT",2483,2632,2072,-411
BANC,"6/4/2017 10 p.m. PDT",2357,2513,2072,-285
BANC,"6/4/2017 11 p.m. PDT",2135,2281,1876,-259
BANC,"6/5/2017 12 a.m. PDT",1893,2016,1579,-314
BANC,"6/5/2017 1 a.m. PDT",1742,1773,1478,-264
BANC,"6/5/2017 2 a.m. PDT",1645,1656,1322,-323
BANC,"6/5/2017 3 a.m. PDT",1605,1591,1399,-206
BANC,"6/5/2017 4 a.m. PDT",1584,1555,1409,-175
BANC,"6/5/2017 5 a.m. PDT",1614,1586,1508,-106
BANC,"6/5/2017 6 a.m. PDT",1687,1660,1579,-108
BANC,"6/5/2017 7 a.m. PDT",1752,1761,1565,-187
BANC,"6/5/2017 8 a.m. PDT",1842,1872,1539,-303
BANC,"6/5/2017 9 a.m. PDT",2171,1981,1782,-389
BANC,"6/5/2017 10 a.m. PDT",2011,2080,1515,-496
BANC,"6/5/2017 11 a.m. PDT",2117,2201,1590,-527
BANC,"6/5/2017 12 p.m. PDT",2218,2323,1586,-632
BANC,"6/5/2017 1 p.m. PDT",2358,2466,1589,-769
BANC,"6/5/2017 2 p.m. PDT",2517,2636,1704,-813
BANC,"6/5/2017 3 p.m. PDT",2689,2812,1956,-733
BANC,"6/5/2017 4 p.m. PDT",2892,2986,2095,-797
BANC,"6/5/2017 5 p.m. PDT",3088,3133,2273,-815
BANC,"6/5/2017 6 p.m. PDT",3171,3210,2298,-873
BANC,"6/5/2017 7 p.m. PDT",3153,3187,2286,-867
BANC,"6/5/2017 8 p.m. PDT",3053,3088,2156,-897
BANC,"6/5/2017 9 p.m. PDT",2884,2947,2069,-815
BANC,"6/5/2017 10 p.m. PDT",2725,2797,2049,-676
BANC,"6/5/2017 11 p.m. PDT",2410,2481,1934,-476
BANC,"6/6/2017 12 a.m. PDT",2109,2169,1657,-452
BANC,"6/6/2017 1 a.m. PDT",1891,1820,1391,-500
BANC,"6/6/2017 2 a.m. PDT",1775,1691,1333,-442
BANC,"6/6/2017 3 a.m. PDT",1702,1625,1283,-419
BANC,"6/6/2017 4 a.m. PDT",1661,1584,1258,-403
BANC,"6/6/2017 5 a.m. PDT",1665,1608,1277,-388
BANC,"6/6/2017 6 a.m. PDT",1736,1675,1606,-130
BANC,"6/6/2017 7 a.m. PDT",1825,1777,1746,-79
BANC,"6/6/2017 8 a.m. PDT",1921,1889,1778,-143
BANC,"6/6/2017 9 a.m. PDT",1990,2010,1567,-423
BANC,"6/6/2017 10 a.m. PDT",2098,2140,1574,-524
BANC,"6/6/2017 11 a.m. PDT",2217,2274,1542,-675
BANC,"6/6/2017 12 p.m. PDT",2337,2403,1717,-620
BANC,"6/6/2017 1 p.m. PDT",2513,2562,1771,-742
BANC,"6/6/2017 2 p.m. PDT",2711,2746,1864,-847
BANC,"6/6/2017 3 p.m. PDT",2922,2921,2190,-732
BANC,"6/6/2017 4 p.m. PDT",3096,3098,2235,-861
BANC,"6/6/2017 5 p.m. PDT",3210,3230,2281,-929
BANC,"6/6/2017 6 p.m. PDT",3262,3283,2299,-963
BANC,"6/6/2017 7 p.m. PDT",3139,3233,2292,-847
BANC,"6/6/2017 8 p.m. PDT",2955,3128,2108,-847
BANC,"6/6/2017 9 p.m. PDT",2774,2979,2035,-739
BANC,"6/6/2017 10 p.m. PDT",2582,2839,2009,-573
BANC,"6/6/2017 11 p.m. PDT",2268,2519,1818,-450
BANC,"6/7/2017 12 a.m. PDT",2007,2201,1603,-404
BANC,"6/7/2017 1 a.m. PDT",1835,1771,1347,-488
BANC,"6/7/2017 2 a.m. PDT",1730,1677,1188,-542
BANC,"6/7/2017 3 a.m. PDT",1663,1619,1158,-505
BANC,"6/7/2017 4 a.m. PDT",1633,1601,1171,-462
BANC,"6/7/2017 5 a.m. PDT",1649,1623,1356,-293
BANC,"6/7/2017 6 a.m. PDT",1718,1694,1508,-210
BANC,"6/7/2017 7 a.m. PDT",1796,1781,1603,-193
BANC,"6/7/2017 8 a.m. PDT",1872,1858,1483,-389
BANC,"6/7/2017 9 a.m. PDT",1945,1936,1497,-448
BANC,"6/7/2017 10 a.m. PDT",2011,2024,1516,-495
BANC,"6/7/2017 11 a.m. PDT",2091,2114,1603,-488
BANC,"6/7/2017 12 p.m. PDT",2183,2206,1714,-469
BANC,"6/7/2017 1 p.m. PDT",2243,2305,1760,-483
BANC,"6/7/2017 2 p.m. PDT",2321,2439,1763,-558
BANC,"6/7/2017 3 p.m. PDT",2405,2589,2036,-369
BANC,"6/7/2017 4 p.m. PDT",2478,2731,2091,-387
BANC,"6/7/2017 5 p.m. PDT",2493,2844,2013,-480
BANC,"6/7/2017 6 p.m. PDT",2484,2891,2058,-426
BANC,"6/7/2017 7 p.m. PDT",2378,2844,2155,-223
BANC,"6/7/2017 8 p.m. PDT",2279,2712,2175,-104
BANC,"6/7/2017 9 p.m. PDT",2277,2610,2029,-248
BANC,"6/7/2017 10 p.m. PDT",2230,2493,2050,-180
BANC,"6/7/2017 11 p.m. PDT",2058,2243,1721,-337
BANC,"6/8/2017 12 a.m. PDT",1891,2002,1378,-513
BANC,"6/8/2017 1 a.m. PDT",1763,1730,1280,-483
BANC,"6/8/2017 2 a.m. PDT",1679,1638,1173,-506
BANC,"6/8/2017 3 a.m. PDT",1628,1584,1125,-503
BANC,"6/8/2017 4 a.m. PDT",1599,1558,1131,-468
BANC,"6/8/2017 5 a.m. PDT",1627,1591,1136,-491
BANC,"6/8/2017 6 a.m. PDT",1714,1662,1697,-17
BANC,"6/8/2017 7 a.m. PDT",1808,1745,1758,-50
BANC,"6/8/2017 8 a.m. PDT",1877,1844,1587,-290
BANC,"6/8/2017 9 a.m. PDT",1907,1930,1485,-422
BANC,"6/8/2017 10 a.m. PDT",1972,1992,1476,-496
BANC,"6/8/2017 11 a.m. PDT",2002,2058,1547,-455
BANC,"6/8/2017 12 p.m. PDT",1998,2092,1547,-451
BANC,"6/8/2017 1 p.m. PDT",1994,2129,1321,-673
BANC,"6/8/2017 2 p.m. PDT",1984,2174,1334,-650
BANC,"6/8/2017 3 p.m. PDT",1978,2211,1444,-534
BANC,"6/8/2017 4 p.m. PDT",2023,2255,1643,-380
BANC,"6/8/2017 5 p.m. PDT",2012,2286,1722,-290
BANC,"6/8/2017 6 p.m. PDT",2035,2295,1803,-232
BANC,"6/8/2017 7 p.m. PDT",2048,2250,1974,-74
BANC,"6/8/2017 8 p.m. PDT",2060,2187,1948,-112
BANC,"6/8/2017 9 p.m. PDT",2131,2182,2007,-124
BANC,"6/8/2017 10 p.m. PDT",2146,2168,2001,-145
BANC,"6/8/2017 11 p.m. PDT",2023,2014,1837,-186
BANC,"6/9/2017 12 a.m. PDT",1861,1828,1583,-278
BANC,"6/9/2017 1 a.m. PDT",1751,1688,1389,-362
BANC,"6/9/2017 2 a.m. PDT",1659,1597,1276,-383
BANC,"6/9/2017 3 a.m. PDT",1621,1552,1271,-350
BANC,"6/9/2017 4 a.m. PDT",1600,1538,1271,-329
BANC,"6/9/2017 5 a.m. PDT",1632,1570,1269,-363
BANC,"6/9/2017 6 a.m. PDT",1704,1642,1626,-78
BANC,"6/9/2017 7 a.m. PDT",1776,1706,1761,-15
BANC,"6/9/2017 8 a.m. PDT",1882,1799,1721,-161
BANC,"6/9/2017 9 a.m. PDT",1957,1886,1558,-399
BANC,"6/9/2017 10 a.m. PDT",1878,1953,1431,-447
BANC,"6/9/2017 11 a.m. PDT",2024,2012,1593,-431
BANC,"6/9/2017 12 p.m. PDT",2129,2061,1688,-441
BANC,"6/9/2017 1 p.m. PDT",2119,2103,1723,-396
BANC,"6/9/2017 2 p.m. PDT",2150,2171,1685,-465
BANC,"6/9/2017 3 p.m. PDT",2191,2219,1824,-367
BANC,"6/9/2017 4 p.m. PDT",2203,2253,1867,-336
BANC,"6/9/2017 5 p.m. PDT",2221,2274,2073,-148
BANC,"6/9/2017 6 p.m. PDT",2210,2278,2034,-176
BANC,"6/9/2017 7 p.m. PDT",2167,2226,2153,-14
BANC,"6/9/2017 8 p.m. PDT",2084,2164,2082,-2
BANC,"6/9/2017 9 p.m. PDT",2085,2179,2060,-25
BANC,"6/9/2017 10 p.m. PDT",2093,2154,2059,-34
BANC,"6/9/2017 11 p.m. PDT",1954,2002,1803,-151
BANC,"6/10/2017 12 a.m. PDT",1807,1831,1541,-266
BANC,"6/10/2017 1 a.m. PDT",1708,1696,1591,-117
BANC,"6/10/2017 2 a.m. PDT",1619,1603,1446,-173
BANC,"6/10/2017 3 a.m. PDT",1563,1547,1572,9
BANC,"6/10/2017 4 a.m. PDT",1536,1518,1482,-54
BANC,"6/10/2017 5 a.m. PDT",1527,1520,1334,-193
BANC,"6/10/2017 6 a.m. PDT",1551,1545,1512,-39
BANC,"6/10/2017 7 a.m. PDT",1538,1533,1662,124
BANC,"6/10/2017 8 a.m. PDT",1563,1586,1405,-158
BANC,"6/10/2017 9 a.m. PDT",1618,1684,1310,-308
BANC,"6/10/2017 10 a.m. PDT",1682,1768,1283,-399
BANC,"6/10/2017 11 a.m. PDT",1729,1828,1286,-443
BANC,"6/10/2017 12 p.m. PDT",1737,1872,1298,-439
BANC,"6/10/2017 1 p.m. PDT",1767,1900,1308,-459
BANC,"6/10/2017 2 p.m. PDT",1773,1924,1359,-414
BANC,"6/10/2017 3 p.m. PDT",1798,1971,1355,-443
BANC,"6/10/2017 4 p.m. PDT",1842,2000,1557,-285
BANC,"6/10/2017 5 p.m. PDT",1888,2037,1526,-362
BANC,"6/10/2017 6 p.m. PDT",1936,2059,1821,-115
BANC,"6/10/2017 7 p.m. PDT",1969,2069,2005,36
BANC,"6/10/2017 8 p.m. PDT",1959,2042,1975,16
BANC,"6/10/2017 9 p.m. PDT",1995,2049,1965,-30
BANC,"6/10/2017 10 p.m. PDT",2006,2050,1983,-23
BANC,"6/10/2017 11 p.m. PDT",1886,1926,1679,-207
BANC,"6/11/2017 12 a.m. PDT",1749,1787,1533,-216
BANC,"6/11/2017 1 a.m. PDT",1652,1619,1542,-110
BANC,"6/11/2017 2 a.m. PDT",1564,1544,1457,-107
BANC,"6/11/2017 3 a.m. PDT",1499,1494,1250,-249
BANC,"6/11/2017 4 a.m. PDT",1474,1469,1211,-263
BANC,"6/11/2017 5 a.m. PDT",1469,1469,1310,-159
BANC,"6/11/2017 6 a.m. PDT",1486,1465,1504,18
BANC,"6/11/2017 7 a.m. PDT",1458,1465,1381,-77
BANC,"6/11/2017 8 a.m. PDT",1485,1556,1302,-183
BANC,"6/11/2017 9 a.m. PDT",1540,1649,1137,-403
BANC,"6/11/2017 10 a.m. PDT",1602,1721,1194,-408
BANC,"6/11/2017 11 a.m. PDT",1642,1794,1289,-353
BANC,"6/11/2017 12 p.m. PDT",1679,1841,1346,-333
BANC,"6/11/2017 1 p.m. PDT",1681,1873,1381,-300
BANC,"6/11/2017 2 p.m. PDT",1703,1897,1339,-364
BANC,"6/11/2017 3 p.m. PDT",1736,1956,1425,-311
BANC,"6/11/2017 4 p.m. PDT",1715,2021,1667,-48
BANC,"6/11/2017 5 p.m. PDT",1741,2064,1619,-122
BANC,"6/11/2017 6 p.m. PDT",1806,2108,1715,-91
BANC,"6/11/2017 7 p.m. PDT",1809,2120,1767,-42
BANC,"6/11/2017 8 p.m. PDT",1859,2095,1722,-137
BANC,"6/11/2017 9 p.m. PDT",1925,2111,1761,-164
BANC,"6/11/2017 10 p.m. PDT",1951,2120,1774,-177
BANC,"6/11/2017 11 p.m. PDT",1835,1956,1470,-365
BANC,"6/12/2017 12 a.m. PDT",1706,1795,1385,-321
BANC,"6/12/2017 1 a.m. PDT",1595,1735,1154,-441
BANC,"6/12/2017 2 a.m. PDT",1532,1640,1115,-417
BANC,"6/12/2017 3 a.m. PDT",1499,1583,1032,-467
BANC,"6/12/2017 4 a.m. PDT",1490,1556,997,-493
BANC,"6/12/2017 5 a.m. PDT",1543,1585,1065,-478
BANC,"6/12/2017 6 a.m. PDT",1617,1649,1382,-235
BANC,"6/12/2017 7 a.m. PDT",1681,1747,1364,-317
BANC,"6/12/2017 8 a.m. PDT",1765,1825,1241,-524
BANC,"6/12/2017 9 a.m. PDT",1840,1905,1226,-614
BANC,"6/12/2017 10 a.m. PDT",1890,1965,1246,-644
BANC,"6/12/2017 11 a.m. PDT",1917,2042,1264,-653
BANC,"6/12/2017 12 p.m. PDT",1936,2106,1233,-703
BANC,"6/12/2017 1 p.m. PDT",1948,2166,1254,-694
BANC,"6/12/2017 2 p.m. PDT",1974,2253,1292,-682
BANC,"6/12/2017 3 p.m. PDT",2017,2358,1505,-512
BANC,"6/12/2017 4 p.m. PDT",2012,2461,1526,-486
BANC,"6/12/2017 5 p.m. PDT",2047,2548,1619,-428
BANC,"6/12/2017 6 p.m. PDT",2090,2573,1748,-342
BANC,"6/12/2017 7 p.m. PDT",2110,2534,1850,-260
BANC,"6/12/2017 8 p.m. PDT",2095,2431,1793,-302
BANC,"6/12/2017 9 p.m. PDT",2128,2372,1781,-347
BANC,"6/12/2017 10 p.m. PDT",2139,2316,1751,-388
BANC,"6/12/2017 11 p.m. PDT",1987,2087,1504,-483
BANC,"6/13/2017 12 a.m. PDT",1793,1886,1338,-455
BANC,"6/13/2017 1 a.m. PDT",1699,1666,1098,-601
BANC,"6/13/2017 2 a.m. PDT",1621,1588,1022,-599
BANC,"6/13/2017 3 a.m. PDT",1571,1547,1048,-523
BANC,"6/13/2017 4 a.m. PDT",1570,1535,1058,-512
BANC,"6/13/2017 5 a.m. PDT",1588,1563,1109,-479
BANC,"6/13/2017 6 a.m. PDT",1654,1633,1329,-325
BANC,"6/13/2017 7 a.m. PDT",1730,1715,1559,-171
BANC,"6/13/2017 8 a.m. PDT",1816,1804,1511,-305
BANC,"6/13/2017 9 a.m. PDT",1883,1884,1440,-443
BANC,"6/13/2017 10 a.m. PDT",1954,1961,1442,-512
BANC,"6/13/2017 11 a.m. PDT",2009,2034,1427,-582
BANC,"6/13/2017 12 p.m. PDT",2068,2105,1490,-578
BANC,"6/13/2017 1 p.m. PDT",2115,2166,1471,-644
BANC,"6/13/2017 2 p.m. PDT",2199,2260,1559,-640
BANC,"6/13/2017 3 p.m. PDT",2276,2345,1631,-645
BANC,"6/13/2017 4 p.m. PDT",2365,2430,1745,-620
BANC,"6/13/2017 5 p.m. PDT",2452,2505,1857,-595
BANC,"6/13/2017 6 p.m. PDT",2531,2549,1954,-577
BANC,"6/13/2017 7 p.m. PDT",2529,2526,2107,-422
BANC,"6/13/2017 8 p.m. PDT",2503,2474,2121,-382
BANC,"6/13/2017 9 p.m. PDT",2448,2409,2059,-389
BANC,"6/13/2017 10 p.m. PDT",2398,2374,1990,-408
BANC,"6/13/2017 11 p.m. PDT",2183,2164,1679,-504
BANC,"6/14/2017 12 a.m. PDT",1941,1942,1420,-521
BANC,"6/14/2017 1 a.m. PDT",1804,1790,1357,-447
BANC,"6/14/2017 2 a.m. PDT",1715,1693,1284,-431
BANC,"6/14/2017 3 a.m. PDT",1641,1624,1216,-425
BANC,"6/14/2017 4 a.m. PDT",1619,1597,1201,-418
BANC,"6/14/2017 5 a.m. PDT",1651,1606,1250,-401
BANC,"6/14/2017 6 a.m. PDT",1724,1678,1570,-154
BANC,"6/14/2017 7 a.m. PDT",1809,1751,1753,-56
BANC,"6/14/2017 8 a.m. PDT",1897,1838,1565,-332
BANC,"6/14/2017 9 a.m. PDT",1976,1927,1546,-430
BANC,"6/14/2017 10 a.m. PDT",2072,2020,1584,-488
BANC,"6/14/2017 11 a.m. PDT",2187,2128,1708,-479
BANC,"6/14/2017 12 p.m. PDT",2308,2230,1699,-609
BANC,"6/14/2017 1 p.m. PDT",2459,2337,2037,-422
BANC,"6/14/2017 2 p.m. PDT",2605,2476,2025,-580
BANC,"6/14/2017 3 p.m. PDT",2774,2621,2072,-702
BANC,"6/14/2017 4 p.m. PDT",2909,2766,2078,-831
BANC,"6/14/2017 5 p.m. PDT",3054,2896,2102,-952
BANC,"6/14/2017 6 p.m. PDT",3132,2958,2181,-951
BANC,"6/14/2017 7 p.m. PDT",3141,2922,2382,-759
BANC,"6/14/2017 8 p.m. PDT",3020,2830,2379,-641
BANC,"6/14/2017 9 p.m. PDT",2864,2707,2292,-572
BANC,"6/14/2017 10 p.m. PDT",2737,2584,2370,-367
BANC,"6/14/2017 11 p.m. PDT",2416,2328,2042,-374
BANC,"6/15/2017 12 a.m. PDT",2138,2070,1651,-487
BANC,"6/15/2017 1 a.m. PDT",1951,1852,1341,-610
BANC,"6/15/2017 2 a.m. PDT",1814,1748,1204,-610
BANC,"6/15/2017 3 a.m. PDT",1720,1669,1116,-604
BANC,"6/15/2017 4 a.m. PDT",1680,1621,1097,-583
BANC,"6/15/2017 5 a.m. PDT",1693,1635,1122,-571
BANC,"6/15/2017 6 a.m. PDT",1760,1697,1418,-342
BANC,"6/15/2017 7 a.m. PDT",1832,1767,1602,-230
BANC,"6/15/2017 8 a.m. PDT",1931,1881,1599,-332
BANC,"6/15/2017 9 a.m. PDT",2025,1997,1499,-526
BANC,"6/15/2017 10 a.m. PDT",2137,2103,1667,-470
BANC,"6/15/2017 11 a.m. PDT",2261,2226,1607,-654
BANC,"6/15/2017 12 p.m. PDT",2420,2365,1841,-579
BANC,"6/15/2017 1 p.m. PDT",2602,2539,1893,-709
BANC,"6/15/2017 2 p.m. PDT",2816,2715,2020,-796
BANC,"6/15/2017 3 p.m. PDT",3024,2921,2162,-862
BANC,"6/15/2017 4 p.m. PDT",3207,3118,2247,-960
BANC,"6/15/2017 5 p.m. PDT",3341,3300,2217,-1124
BANC,"6/15/2017 6 p.m. PDT",3414,3368,2269,-1145
BANC,"6/15/2017 7 p.m. PDT",3390,3318,2456,-934
BANC,"6/15/2017 8 p.m. PDT",3284,3148,2483,-801
BANC,"6/15/2017 9 p.m. PDT",3128,2937,2447,-681
BANC,"6/15/2017 10 p.m. PDT",2976,2775,2424,-552
BANC,"6/15/2017 11 p.m. PDT",2681,2475,2144,-537
BANC,"6/16/2017 12 a.m. PDT",2376,2173,1692,-684
BANC,"6/16/2017 1 a.m. PDT",2131,2149,1303,-828
BANC,"6/16/2017 2 a.m. PDT",1970,1984,1323,-647
BANC,"6/16/2017 3 a.m. PDT",1868,1885,1271,-597
BANC,"6/16/2017 4 a.m. PDT",1830,1828,1256,-574
BANC,"6/16/2017 5 a.m. PDT",1830,1823,1234,-596
BANC,"6/16/2017 6 a.m. PDT",1902,1879,1531,-371
BANC,"6/16/2017 7 a.m. PDT",1989,1955,1749,-240
BANC,"6/16/2017 8 a.m. PDT",2134,2103,1715,-419
BANC,"6/16/2017 9 a.m. PDT",2307,2279,1611,-696
BANC,"6/16/2017 10 a.m. PDT",2487,2500,1718,-769
BANC,"6/16/2017 11 a.m. PDT",2707,2751,1944,-763
BANC,"6/16/2017 12 p.m. PDT",2939,3019,2107,-832
BANC,"6/16/2017 1 p.m. PDT",3162,3299,2116,-1046
BANC,"6/16/2017 2 p.m. PDT",3403,3566,2122,-1281
BANC,"6/16/2017 3 p.m. PDT",3616,3784,2110,-1506
BANC,"6/16/2017 4 p.m. PDT",3808,3967,2088,-1720
BANC,"6/16/2017 5 p.m. PDT",3951,4067,2154,-1797
BANC,"6/16/2017 6 p.m. PDT",4010,4115,2188,-1822
BANC,"6/16/2017 7 p.m. PDT",3934,3993,2328,-1606
BANC,"6/16/2017 8 p.m. PDT",3789,3797,2293,-1496
BANC,"6/16/2017 9 p.m. PDT",3609,3560,2351,-1258
BANC,"6/16/2017 10 p.m. PDT",3460,3331,2403,-1057
BANC,"6/16/2017 11 p.m. PDT",3127,2954,2177,-950
BANC,"6/17/2017 12 a.m. PDT",2780,2594,1835,-945
BANC,"6/17/2017 1 a.m. PDT",2503,2370,1731,-772
BANC,"6/17/2017 2 a.m. PDT",2299,2152,1611,-688
BANC,"6/17/2017 3 a.m. PDT",2152,2007,1484,-668
BANC,"6/17/2017 4 a.m. PDT",2038,1908,1461,-577
BANC,"6/17/2017 5 a.m. PDT",1975,1863,1463,-512
BANC,"6/17/2017 6 a.m. PDT",1933,1860,1520,-413
BANC,"6/17/2017 7 a.m. PDT",1951,1878,1680,-271
BANC,"6/17/2017 8 a.m. PDT",2072,2029,1690,-382
BANC,"6/17/2017 9 a.m. PDT",2285,2243,1796,-489
BANC,"6/17/2017 10 a.m. PDT",2532,2508,1916,-616
BANC,"6/17/2017 11 a.m. PDT",2757,2808,2032,-725
BANC,"6/17/2017 12 p.m. PDT",2981,3092,2017,-964
BANC,"6/17/2017 1 p.m. PDT",3182,3365,1958,-1224
BANC,"6/17/2017 2 p.m. PDT",3380,3598,1958,-1422
BANC,"6/17/2017 3 p.m. PDT",3523,3807,1981,-1542
BANC,"6/17/2017 4 p.m. PDT",3692,3973,1933,-1759
BANC,"6/17/2017 5 p.m. PDT",3802,4072,2139,-1663
BANC,"6/17/2017 6 p.m. PDT",3854,4100,2139,-1715
BANC,"6/17/2017 7 p.m. PDT",3846,4050,2332,-1514
BANC,"6/17/2017 8 p.m. PDT",3728,3896,2322,-1406
BANC,"6/17/2017 9 p.m. PDT",3574,3648,2317,-1257
BANC,"6/17/2017 10 p.m. PDT",3415,3417,2280,-1135
BANC,"6/17/2017 11 p.m. PDT",3125,3051,2138,-987
BANC,"6/18/2017 12 a.m. PDT",2799,2679,1916,-883
BANC,"6/18/2017 1 a.m. PDT",2520,2573,1608,-912
BANC,"6/18/2017 2 a.m. PDT",2320,2342,1542,-778
BANC,"6/18/2017 3 a.m. PDT",2204,2174,1617,-587
BANC,"6/18/2017 4 a.m. PDT",2094,2052,1537,-557
BANC,"6/18/2017 5 a.m. PDT",2039,1976,1506,-533
BANC,"6/18/2017 6 a.m. PDT",1989,1933,1646,-343
BANC,"6/18/2017 7 a.m. PDT",1998,1906,1745,-253
BANC,"6/18/2017 8 a.m. PDT",2136,2048,1720,-416
BANC,"6/18/2017 9 a.m. PDT",2381,2254,1883,-498
BANC,"6/18/2017 10 a.m. PDT",2646,2538,1927,-719
BANC,"6/18/2017 11 a.m. PDT",2933,2862,1935,-998
BANC,"6/18/2017 12 p.m. PDT",3230,3152,1991,-1239
BANC,"6/18/2017 1 p.m. PDT",3481,3451,2000,-1481
BANC,"6/18/2017 2 p.m. PDT",3756,3709,2187,-1569
BANC,"6/18/2017 3 p.m. PDT",3946,3896,2425,-1521
BANC,"6/18/2017 4 p.m. PDT",4125,4071,2503,-1622
BANC,"6/18/2017 5 p.m. PDT",4250,4177,2566,-1684
BANC,"6/18/2017 6 p.m. PDT",4303,4236,2568,-1735
BANC,"6/18/2017 7 p.m. PDT",4302,4196,2595,-1707
BANC,"6/18/2017 8 p.m. PDT",4196,4041,2577,-1619
BANC,"6/18/2017 9 p.m. PDT",4079,3839,2565,-1514
BANC,"6/18/2017 10 p.m. PDT",3922,3649,2465,-1457
BANC,"6/18/2017 11 p.m. PDT",3567,3248,2234,-1333
BANC,"6/19/2017 12 a.m. PDT",3178,2838,2039,-1139
BANC,"6/19/2017 1 a.m. PDT",2849,2494,1880,-969
BANC,"6/19/2017 2 a.m. PDT",2611,2269,1829,-782
BANC,"6/19/2017 3 a.m. PDT",2437,2122,1865,-572
BANC,"6/19/2017 4 a.m. PDT",2341,2015,1785,-556
BANC,"6/19/2017 5 a.m. PDT",2301,1996,1696,-605
BANC,"6/19/2017 6 a.m. PDT",2287,2041,1685,-602
BANC,"6/19/2017 7 a.m. PDT",2435,2108,2056,-379
BANC,"6/19/2017 8 a.m. PDT",2590,2287,2126,-464
BANC,"6/19/2017 9 a.m. PDT",2805,2465,2058,-747
BANC,"6/19/2017 10 a.m. PDT",3043,2720,2123,-920
BANC,"6/19/2017 11 a.m. PDT",3363,3002,2307,-1056
BANC,"6/19/2017 12 p.m. PDT",3686,3328,2498,-1188
BANC,"6/19/2017 1 p.m. PDT",3997,3639,2491,-1506
BANC,"6/19/2017 2 p.m. PDT",4286,3932,2539,-1747
BANC,"6/19/2017 3 p.m. PDT",4500,4181,2745,-1755
BANC,"6/19/2017 4 p.m. PDT",4680,4368,2773,-1907
BANC,"6/19/2017 5 p.m. PDT",4763,4439,2858,-1905
BANC,"6/19/2017 6 p.m. PDT",4731,4466,2932,-1799
BANC,"6/19/2017 7 p.m. PDT",4620,4355,2846,-1774
BANC,"6/19/2017 8 p.m. PDT",4438,4189,2747,-1691
BANC,"6/19/2017 9 p.m. PDT",4208,4005,2619,-1589
BANC,"6/19/2017 10 p.m. PDT",3930,3782,2472,-1458
BANC,"6/19/2017 11 p.m. PDT",3486,3403,2040,-1446
BANC,"6/20/2017 12 a.m. PDT",3070,3001,1819,-1251
BANC,"6/20/2017 1 a.m. PDT",2761,2763,1683,-1078
BANC,"6/20/2017 2 a.m. PDT",2522,2571,1584,-938
BANC,"6/20/2017 3 a.m. PDT",2365,2402,1566,-799
BANC,"6/20/2017 4 a.m. PDT",2262,2259,1568,-694
BANC,"6/20/2017 5 a.m. PDT",2220,2236,1496,-724
BANC,"6/20/2017 6 a.m. PDT",2247,2309,1504,-743
BANC,"6/20/2017 7 a.m. PDT",2357,2426,1692,-665
BANC,"6/20/2017 8 a.m. PDT",2534,2594,1750,-784
BANC,"6/20/2017 9 a.m. PDT",2725,2808,1947,-778
BANC,"6/20/2017 10 a.m. PDT",2978,3034,1996,-982
BANC,"6/20/2017 11 a.m. PDT",3236,3275,1992,-1244
BANC,"6/20/2017 12 p.m. PDT",3558,3516,2186,-1372
BANC,"6/20/2017 1 p.m. PDT",3893,3758,2477,-1416
BANC,"6/20/2017 2 p.m. PDT",4202,3992,2527,-1675
BANC,"6/20/2017 3 p.m. PDT",4450,4229,2585,-1865
BANC,"6/20/2017 4 p.m. PDT",4644,4415,2685,-1959
BANC,"6/20/2017 5 p.m. PDT",4742,4509,2693,-2049
BANC,"6/20/2017 6 p.m. PDT",4747,4529,2671,-2076
BANC,"6/20/2017 7 p.m. PDT",4617,4420,2680,-1937
BANC,"6/20/2017 8 p.m. PDT",4398,4246,2498,-1900
BANC,"6/20/2017 9 p.m. PDT",4134,4066,2362,-1772
BANC,"6/20/2017 10 p.m. PDT",3857,3799,2274,-1583
BANC,"6/20/2017 11 p.m. PDT",3443,3419,2037,-1406
BANC,"6/21/2017 12 a.m. PDT",3003,3012,1767,-1236
BANC,"6/21/2017 1 a.m. PDT",2674,2712,1610,-1064
BANC,"6/21/2017 2 a.m. PDT",2443,2442,1568,-875
BANC,"6/21/2017 3 a.m. PDT",2258,2345,1475,-783
BANC,"6/21/2017 4 a.m. PDT",2140,2225,1399,-741
BANC,"6/21/2017 5 a.m. PDT",2116,2184,1445,-671
BANC,"6/21/2017 6 a.m. PDT",2158,2213,1665,-493
BANC,"6/21/2017 7 a.m. PDT",2232,2291,1872,-360
BANC,"6/21/2017 8 a.m. PDT",2393,2451,1927,-466
BANC,"6/21/2017 9 a.m. PDT",2556,2624,1929,-627
BANC,"6/21/2017 10 a.m. PDT",2780,2866,1982,-798
BANC,"6/21/2017 11 a.m. PDT",3060,3135,2112,-948
BANC,"6/21/2017 12 p.m. PDT",3349,3424,2260,-1089
BANC,"6/21/2017 1 p.m. PDT",3680,3737,2288,-1392
BANC,"6/21/2017 2 p.m. PDT",4013,4053,2498,-1515
BANC,"6/21/2017 3 p.m. PDT",4251,4268,2607,-1644
BANC,"6/21/2017 4 p.m. PDT",4483,4482,2628,-1855
BANC,"6/21/2017 5 p.m. PDT",4624,4607,2664,-1960
BANC,"6/21/2017 6 p.m. PDT",4691,4644,2720,-1971
BANC,"6/21/2017 7 p.m. PDT",4605,4562,2715,-1890
BANC,"6/21/2017 8 p.m. PDT",4441,4394,2691,-1750
BANC,"6/21/2017 9 p.m. PDT",4232,4143,2600,-1632
BANC,"6/21/2017 10 p.m. PDT",4009,3920,2500,-1509
BANC,"6/21/2017 11 p.m. PDT",3608,3513,2163,-1445
BANC,"6/22/2017 12 a.m. PDT",3219,3115,1844,-1375
BANC,"6/22/2017 1 a.m. PDT",2898,2800,1672,-1226
BANC,"6/22/2017 2 a.m. PDT",2687,2561,1594,-1093
BANC,"6/22/2017 3 a.m. PDT",2512,2401,1602,-910
BANC,"6/22/2017 4 a.m. PDT",2406,2275,1582,-824
BANC,"6/22/2017 5 a.m. PDT",2367,2250,1515,-852
BANC,"6/22/2017 6 a.m. PDT",2399,2297,1587,-812
BANC,"6/22/2017 7 a.m. PDT",2522,2396,1882,-640
BANC,"6/22/2017 8 a.m. PDT",2736,2559,1957,-779
BANC,"6/22/2017 9 a.m. PDT",2928,2754,2036,-892
BANC,"6/22/2017 10 a.m. PDT",3170,3017,2027,-1143
BANC,"6/22/2017 11 a.m. PDT",3436,3356,2067,-1369
BANC,"6/22/2017 12 p.m. PDT",3664,3700,2063,-1601
BANC,"6/22/2017 1 p.m. PDT",3939,4040,2137,-1802
BANC,"6/22/2017 2 p.m. PDT",4186,4353,2362,-1824
BANC,"6/22/2017 3 p.m. PDT",4404,4521,2445,-1959
BANC,"6/22/2017 4 p.m. PDT",4548,4693,2465,-2083
BANC,"6/22/2017 5 p.m. PDT",4646,4781,2708,-1938
BANC,"6/22/2017 6 p.m. PDT",4683,4718,2722,-1961
BANC,"6/22/2017 7 p.m. PDT",4603,4547,2679,-1924
BANC,"6/22/2017 8 p.m. PDT",4434,4352,2615,-1819
BANC,"6/22/2017 9 p.m. PDT",4178,4110,2560,-1618
BANC,"6/22/2017 10 p.m. PDT",3906,3864,2512,-1394
BANC,"6/22/2017 11 p.m. PDT",3476,3427,1956,-1520
BANC,"6/23/2017 12 a.m. PDT",3053,2990,1626,-1427
BANC,"6/23/2017 1 a.m. PDT",2726,2612,1685,-1041
BANC,"6/23/2017 2 a.m. PDT",2477,2381,1519,-958
BANC,"6/23/2017 3 a.m. PDT",2294,2218,1508,-786
BANC,"6/23/2017 4 a.m. PDT",2189,2117,1474,-715
BANC,"6/23/2017 5 a.m. PDT",2142,2099,1454,-688
BANC,"6/23/2017 6 a.m. PDT",2186,2133,1536,-650
BANC,"6/23/2017 7 a.m. PDT",2254,2195,1798,-456
BANC,"6/23/2017 8 a.m. PDT",2433,2331,1873,-560
BANC,"6/23/2017 9 a.m. PDT",2617,2467,1939,-678
BANC,"6/23/2017 10 a.m. PDT",2813,2689,1964,-849
BANC,"6/23/2017 11 a.m. PDT",3073,2957,2089,-984
BANC,"6/23/2017 12 p.m. PDT",3327,3259,2115,-1212
BANC,"6/23/2017 1 p.m. PDT",3591,3567,2175,-1416
BANC,"6/23/2017 2 p.m. PDT",3874,3864,2353,-1521
BANC,"6/23/2017 3 p.m. PDT",4047,4129,2556,-1491
BANC,"6/23/2017 4 p.m. PDT",4248,4328,2587,-1661
BANC,"6/23/2017 5 p.m. PDT",4365,4462,2618,-1747
BANC,"6/23/2017 6 p.m. PDT",4384,4483,2745,-1639
BANC,"6/23/2017 7 p.m. PDT",4244,4349,2666,-1578
BANC,"6/23/2017 8 p.m. PDT",3987,4139,2519,-1468
BANC,"6/23/2017 9 p.m. PDT",3701,3865,2326,-1375
BANC,"6/23/2017 10 p.m. PDT",3453,3610,2278,-1175
BANC,"6/23/2017 11 p.m. PDT",3047,3214,1669,-1378
BANC,"6/24/2017 12 a.m. PDT",2646,2817,1439,-1207
BANC,"6/24/2017 1 a.m. PDT",2346,2477,1587,-759
BANC,"6/24/2017 2 a.m. PDT",2146,2263,1295,-851
BANC,"6/24/2017 3 a.m. PDT",2006,2116,1362,-644
BANC,"6/24/2017 4 a.m. PDT",1908,2016,1353,-555
BANC,"6/24/2017 5 a.m. PDT",1869,1969,1373,-496
BANC,"6/24/2017 6 a.m. PDT",1835,1936,1338,-497
BANC,"6/24/2017 7 a.m. PDT",1835,1925,1576,-259
BANC,"6/24/2017 8 a.m. PDT",1936,2029,1672,-264
BANC,"6/24/2017 9 a.m. PDT",2086,2195,1846,-240
BANC,"6/24/2017 10 a.m. PDT",2243,2428,1788,-455
BANC,"6/24/2017 11 a.m. PDT",2436,2671,1839,-597
BANC,"6/24/2017 12 p.m. PDT",2662,2940,1864,-798
BANC,"6/24/2017 1 p.m. PDT",2903,3197,1878,-1025
BANC,"6/24/2017 2 p.m. PDT",3187,3464,2019,-1168
BANC,"6/24/2017 3 p.m. PDT",3449,3738,2219,-1230
BANC,"6/24/2017 4 p.m. PDT",3640,3926,2178,-1462
BANC,"6/24/2017 5 p.m. PDT",3780,4018,2231,-1549
BANC,"6/24/2017 6 p.m. PDT",3829,4034,2341,-1488
BANC,"6/24/2017 7 p.m. PDT",3737,3950,2292,-1445
BANC,"6/24/2017 8 p.m. PDT",3555,3830,2208,-1347
BANC,"6/24/2017 9 p.m. PDT",3305,3581,2165,-1140
BANC,"6/24/2017 10 p.m. PDT",3043,3362,1975,-1068
BANC,"6/24/2017 11 p.m. PDT",2732,3037,1489,-1243
BANC,"6/25/2017 12 a.m. PDT",2461,2676,1485,-976
BANC,"6/25/2017 1 a.m. PDT",2226,2158,1547,-679
BANC,"6/25/2017 2 a.m. PDT",2056,1976,1447,-609
BANC,"6/25/2017 3 a.m. PDT",1921,1852,1343,-578
BANC,"6/25/2017 4 a.m. PDT",1831,1770,1270,-561
BANC,"6/25/2017 5 a.m. PDT",1785,1726,1314,-471
BANC,"6/25/2017 6 a.m. PDT",1751,1701,1346,-405
BANC,"6/25/2017 7 a.m. PDT",1728,1694,1624,-104
BANC,"6/25/2017 8 a.m. PDT",1793,1785,1712,-81
BANC,"6/25/2017 9 a.m. PDT",1896,1925,1802,-94
BANC,"6/25/2017 10 a.m. PDT",2010,2125,1724,-286
BANC,"6/25/2017 11 a.m. PDT",2176,2341,1749,-427
BANC,"6/25/2017 12 p.m. PDT",2330,2524,1740,-590
BANC,"6/25/2017 1 p.m. PDT",2507,2752,1809,-698
BANC,"6/25/2017 2 p.m. PDT",2698,3020,1840,-858
BANC,"6/25/2017 3 p.m. PDT",2906,3288,1898,-1008
BANC,"6/25/2017 4 p.m. PDT",3121,3462,1977,-1144
BANC,"6/25/2017 5 p.m. PDT",3270,3585,2235,-1035
BANC,"6/25/2017 6 p.m. PDT",3331,3643,2312,-1019
BANC,"6/25/2017 7 p.m. PDT",3286,3472,2280,-1006
BANC,"6/25/2017 8 p.m. PDT",3119,3297,2294,-825
BANC,"6/25/2017 9 p.m. PDT",2878,3081,2015,-863
BANC,"6/25/2017 10 p.m. PDT",2675,2914,1900,-775
BANC,"6/25/2017 11 p.m. PDT",2389,2534,1558,-831
BANC,"6/26/2017 12 a.m. PDT",2108,2269,1466,-642
BANC,"6/26/2017 1 a.m. PDT",1905,1986,1296,-609
BANC,"6/26/2017 2 a.m. PDT",1783,1839,1231,-552
BANC,"6/26/2017 3 a.m. PDT",1710,1749,1231,-479
BANC,"6/26/2017 4 a.m. PDT",1670,1711,1174,-496
BANC,"6/26/2017 5 a.m. PDT",1705,1719,1351,-354
BANC,"6/26/2017 6 a.m. PDT",1744,1776,1340,-404
BANC,"6/26/2017 7 a.m. PDT",1839,1867,1543,-296
BANC,"6/26/2017 8 a.m. PDT",1922,1993,1670,-252
BANC,"6/26/2017 9 a.m. PDT",2024,2120,1724,-300
BANC,"6/26/2017 10 a.m. PDT",2098,2261,1807,-291
BANC,"6/26/2017 11 a.m. PDT",2191,2418,1643,-548
BANC,"6/26/2017 12 p.m. PDT",2275,2564,1763,-512
BANC,"6/26/2017 1 p.m. PDT",2368,2742,1753,-615
BANC,"6/26/2017 2 p.m. PDT",2499,2922,1859,-640
BANC,"6/26/2017 3 p.m. PDT",2639,3125,2006,-633
BANC,"6/26/2017 4 p.m. PDT",2795,3303,2104,-691
BANC,"6/26/2017 5 p.m. PDT",2912,3426,2193,-719
BANC,"6/26/2017 6 p.m. PDT",2973,3456,2313,-660
BANC,"6/26/2017 7 p.m. PDT",2935,3371,2332,-603
BANC,"6/26/2017 8 p.m. PDT",2766,3149,2126,-640
BANC,"6/26/2017 9 p.m. PDT",2607,2948,1990,-617
BANC,"6/26/2017 10 p.m. PDT",2478,2773,1897,-581
BANC,"6/26/2017 11 p.m. PDT",2257,2458,1520,-737
BANC,"6/27/2017 12 a.m. PDT",2017,2162,1235,-782
BANC,"6/27/2017 1 a.m. PDT",1850,1845,1175,-675
BANC,"6/27/2017 2 a.m. PDT",1730,1730,1136,-594
BANC,"6/27/2017 3 a.m. PDT",1675,1667,1250,-425
BANC,"6/27/2017 4 a.m. PDT",1643,1625,1242,-401
BANC,"6/27/2017 5 a.m. PDT",1669,1649,1192,-477
BANC,"6/27/2017 6 a.m. PDT",1729,1700,1360,-369
BANC,"6/27/2017 7 a.m. PDT",1822,1789,1701,-121
BANC,"6/27/2017 8 a.m. PDT",1901,1884,1541,-360
BANC,"6/27/2017 9 a.m. PDT",1985,1995,1551,-434
BANC,"6/27/2017 10 a.m. PDT",2074,2104,1559,-515
BANC,"6/27/2017 11 a.m. PDT",2182,2214,1619,-563
BANC,"6/27/2017 12 p.m. PDT",2297,2328,1784,-513
BANC,"6/27/2017 1 p.m. PDT",2417,2457,1871,-546
BANC,"6/27/2017 2 p.m. PDT",2588,2629,1931,-657
BANC,"6/27/2017 3 p.m. PDT",2746,2791,2206,-540
BANC,"6/27/2017 4 p.m. PDT",2907,2970,2117,-790
BANC,"6/27/2017 5 p.m. PDT",3067,3119,2178,-889
BANC,"6/27/2017 6 p.m. PDT",3144,3162,2205,-939
BANC,"6/27/2017 7 p.m. PDT",3044,3095,2321,-723
BANC,"6/27/2017 8 p.m. PDT",2881,2945,2273,-608
BANC,"6/27/2017 9 p.m. PDT",2660,2766,2143,-517
BANC,"6/27/2017 10 p.m. PDT",2524,2612,1991,-533
BANC,"6/27/2017 11 p.m. PDT",2262,2364,1552,-710
BANC,"6/28/2017 12 a.m. PDT",2014,2102,1177,-837
BANC,"6/28/2017 1 a.m. PDT",1843,1879,1166,-677
BANC,"6/28/2017 2 a.m. PDT",1737,1763,1190,-547
BANC,"6/28/2017 3 a.m. PDT",1656,1689,1137,-519
BANC,"6/28/2017 4 a.m. PDT",1639,1653,1179,-460
BANC,"6/28/2017 5 a.m. PDT",1653,1663,1192,-461
BANC,"6/28/2017 6 a.m. PDT",1720,1721,1221,-499
BANC,"6/28/2017 7 a.m. PDT",1796,1803,1497,-299
BANC,"6/28/2017 8 a.m. PDT",1887,1911,1423,-464
BANC,"6/28/2017 9 a.m. PDT",1959,2010,1416,-543
BANC,"6/28/2017 10 a.m. PDT",2043,2115,1491,-552
BANC,"6/28/2017 11 a.m. PDT",2145,2246,1464,-681
BANC,"6/28/2017 12 p.m. PDT",2263,2380,1575,-688
BANC,"6/28/2017 1 p.m. PDT",2378,2524,1776,-602
BANC,"6/28/2017 2 p.m. PDT",2568,2685,1953,-615
BANC,"6/28/2017 3 p.m. PDT",2770,2890,2131,-639
BANC,"6/28/2017 4 p.m. PDT",2978,3070,2235,-743
BANC,"6/28/2017 5 p.m. PDT",3186,3256,2307,-879
BANC,"6/28/2017 6 p.m. PDT",3304,3311,2476,-828
BANC,"6/28/2017 7 p.m. PDT",3293,3265,2509,-784
BANC,"6/28/2017 8 p.m. PDT",3152,3137,2413,-739
BANC,"6/28/2017 9 p.m. PDT",2946,2926,2329,-617
BANC,"6/28/2017 10 p.m. PDT",2760,2745,2272,-488
BANC,"6/28/2017 11 p.m. PDT",2443,2461,1678,-765
BANC,"6/29/2017 12 a.m. PDT",2142,2176,1504,-638
BANC,"6/29/2017 1 a.m. PDT",1938,1943,1491,-447
BANC,"6/29/2017 2 a.m. PDT",1809,1805,1267,-542
BANC,"6/29/2017 3 a.m. PDT",1717,1717,1230,-487
BANC,"6/29/2017 4 a.m. PDT",1673,1665,1246,-427
BANC,"6/29/2017 5 a.m. PDT",1690,1679,1250,-440
BANC,"6/29/2017 6 a.m. PDT",1752,1730,1312,-440
BANC,"6/29/2017 7 a.m. PDT",1806,1808,1610,-196
BANC,"6/29/2017 8 a.m. PDT",1916,1931,1648,-268
BANC,"6/29/2017 9 a.m. PDT",1992,2046,1429,-563
BANC,"6/29/2017 10 a.m. PDT",2092,2176,1564,-528
BANC,"6/29/2017 11 a.m. PDT",2207,2327,1468,-739
BANC,"6/29/2017 12 p.m. PDT",2357,2513,1490,-867
BANC,"6/29/2017 1 p.m. PDT",2512,2702,1518,-994
BANC,"6/29/2017 2 p.m. PDT",2760,2900,2049,-711
BANC,"6/29/2017 3 p.m. PDT",3003,3113,2296,-707
BANC,"6/29/2017 4 p.m. PDT",3259,3324,2486,-773
BANC,"6/29/2017 5 p.m. PDT",3439,3512,2519,-920
BANC,"6/29/2017 6 p.m. PDT",3526,3604,2582,-944
BANC,"6/29/2017 7 p.m. PDT",3477,3550,2615,-862
BANC,"6/29/2017 8 p.m. PDT",3278,3373,2449,-829
BANC,"6/29/2017 9 p.m. PDT",3011,3156,2334,-677
BANC,"6/29/2017 10 p.m. PDT",2773,2933,2163,-610
BANC,"6/29/2017 11 p.m. PDT",2432,2567,1915,-517
BANC,"6/30/2017 12 a.m. PDT",2140,2245,1646,-494
BANC,"6/30/2017 1 a.m. PDT",1925,1991,1475,-450
BANC,"6/30/2017 2 a.m. PDT",1785,1849,1270,-515
BANC,"6/30/2017 3 a.m. PDT",1712,1760,1235,-477
BANC,"6/30/2017 4 a.m. PDT",1669,1713,1220,-449
BANC,"6/30/2017 5 a.m. PDT",1677,1717,1212,-465
BANC,"6/30/2017 6 a.m. PDT",1735,1761,1244,-491
BANC,"6/30/2017 7 a.m. PDT",1800,1835,1577,-223
BANC,"6/30/2017 8 a.m. PDT",1881,1940,1506,-375
BANC,"6/30/2017 9 a.m. PDT",1979,2065,1333,-646
BANC,"6/30/2017 10 a.m. PDT",2076,2202,1403,-673
BANC,"6/30/2017 11 a.m. PDT",2202,2382,1410,-792
BANC,"6/30/2017 12 p.m. PDT",2325,2574,1439,-886
BANC,"6/30/2017 1 p.m. PDT",2479,2778,1533,-946
BANC,"6/30/2017 2 p.m. PDT",2710,3002,1914,-796
BANC,"6/30/2017 3 p.m. PDT",2969,3224,2276,-693
BANC,"6/30/2017 4 p.m. PDT",3205,3416,2343,-862
BANC,"6/30/2017 5 p.m. PDT",3372,3572,2400,-972
BANC,"6/30/2017 6 p.m. PDT",3465,3636,2490,-975
BANC,"6/30/2017 7 p.m. PDT",3390,3585,2588,-802
BANC,"6/30/2017 8 p.m. PDT",3195,3397,2506,-689
BANC,"6/30/2017 9 p.m. PDT",2963,3188,2444,-519
BANC,"6/30/2017 10 p.m. PDT",2754,2975,2132,-622
BANC,"6/30/2017 11 p.m. PDT",2447,2652,2001,-446
BANC,"7/1/2017 12 a.m. PDT",2180,2340,1680,-500
