"BA Code","Timestamp (Hour Ending)","Demand (MWh)","Demand Forecast (MWh)","Net Generation (MWh)","Total Interchange (MWh)"
BANC,"8/1/2017 12 a.m. PDT",2521,2626,1489,-1032
BANC,"8/1/2017 1 a.m. PDT",2270,2312,1438,-832
BANC,"8/1/2017 2 a.m. PDT",2089,2112,1263,-826
BANC,"8/1/2017 3 a.m. PDT",1965,1974,1152,-813
BANC,"8/1/2017 4 a.m. PDT",1904,1911,1110,-794
BANC,"8/1/2017 5 a.m. PDT",1894,1894,1107,-787
BANC,"8/1/2017 6 a.m. PDT",1969,1963,1186,-783
BANC,"8/1/2017 7 a.m. PDT",2025,2028,1563,-462
BANC,"8/1/2017 8 a.m. PDT",2139,2166,1683,-456
BANC,"8/1/2017 9 a.m. PDT",2271,2332,1718,-553
BANC,"8/1/2017 10 a.m. PDT",2435,2556,1788,-647
BANC,"8/1/2017 11 a.m. PDT",2697,2808,1864,-833
BANC,"8/1/2017 12 p.m. PDT",2997,3089,1961,-1036
BANC,"8/1/2017 1 p.m. PDT",3335,3409,2071,-1264
BANC,"8/1/2017 2 p.m. PDT",3668,3726,2238,-1430
BANC,"8/1/2017 3 p.m. PDT",3999,3990,2540,-1459
BANC,"8/1/2017 4 p.m. PDT",4220,4229,2607,-1613
BANC,"8/1/2017 5 p.m. PDT",4389,4350,2690,-1699
BANC,"8/1/2017 6 p.m. PDT",4444,4374,2802,-1642
BANC,"8/1/2017 7 p.m. PDT",4374,4292,2797,-1577
BANC,"8/1/2017 8 p.m. PDT",4154,4073,2685,-1469
BANC,"8/1/2017 9 p.m. PDT",3920,3858,2627,-1293
BANC,"8/1/2017 10 p.m. PDT",3603,3569,2472,-1131
BANC,"8/1/2017 11 p.m. PDT",3193,3177,1751,-1442
BANC,"8/2/2017 12 a.m. PDT",2834,2768,1676,-1158
BANC,"8/2/2017 1 a.m. PDT",2545,2451,1663,-882
BANC,"8/2/2017 2 a.m. PDT",2309,2237,1470,-839
BANC,"8/2/2017 3 a.m. PDT",2198,2082,1312,-886
BANC,"8/2/2017 4 a.m. PDT",2100,1990,1315,-785
BANC,"8/2/2017 5 a.m. PDT",2069,1964,1289,-780
BANC,"8/2/2017 6 a.m. PDT",2141,2021,1390,-751
BANC,"8/2/2017 7 a.m. PDT",2199,2094,1877,-322
BANC,"8/2/2017 8 a.m. PDT",2319,2214,1956,-363
BANC,"8/2/2017 9 a.m. PDT",2482,2376,2061,-421
BANC,"8/2/2017 10 a.m. PDT",2691,2566,2137,-554
BANC,"8/2/2017 11 a.m. PDT",2941,2807,2086,-855
BANC,"8/2/2017 12 p.m. PDT",3215,3110,2218,-997
BANC,"8/2/2017 1 p.m. PDT",3535,3417,2191,-1344
BANC,"8/2/2017 2 p.m. PDT",3845,3722,2267,-1578
BANC,"8/2/2017 3 p.m. PDT",4121,4004,2550,-1571
BANC,"8/2/2017 4 p.m. PDT",4312,4223,2756,-1556
BANC,"8/2/2017 5 p.m. PDT",4419,4383,2883,-1536
BANC,"8/2/2017 6 p.m. PDT",4396,4399,2882,-1514
BANC,"8/2/2017 7 p.m. PDT",4237,4285,2720,-1517
BANC,"8/2/2017 8 p.m. PDT",3997,4060,2510,-1487
BANC,"8/2/2017 9 p.m. PDT",3778,3822,2541,-1237
BANC,"8/2/2017 10 p.m. PDT",3512,3536,2324,-1188
BANC,"8/2/2017 11 p.m. PDT",3118,3127,2019,-1099
BANC,"8/3/2017 12 a.m. PDT",2765,2725,1804,-961
BANC,"8/3/2017 1 a.m. PDT",2475,2500,1622,-853
BANC,"8/3/2017 2 a.m. PDT",2344,2273,1567,-777
BANC,"8/3/2017 3 a.m. PDT",2180,2123,1394,-786
BANC,"8/3/2017 4 a.m. PDT",2120,2021,1316,-804
BANC,"8/3/2017 5 a.m. PDT",2103,1974,1342,-761
BANC,"8/3/2017 6 a.m. PDT",2156,2052,1511,-645
BANC,"8/3/2017 7 a.m. PDT",2251,2131,1847,-404
BANC,"8/3/2017 8 a.m. PDT",2370,2282,1900,-470
BANC,"8/3/2017 9 a.m. PDT",2532,2442,1933,-599
BANC,"8/3/2017 10 a.m. PDT",2741,2639,2024,-717
BANC,"8/3/2017 11 a.m. PDT",3005,2884,2178,-827
BANC,"8/3/2017 12 p.m. PDT",3302,3167,2476,-826
BANC,"8/3/2017 1 p.m. PDT",3580,3468,2514,-1066
BANC,"8/3/2017 2 p.m. PDT",3843,3748,2585,-1258
BANC,"8/3/2017 3 p.m. PDT",4063,4001,2648,-1415
BANC,"8/3/2017 4 p.m. PDT",4167,4222,2593,-1574
BANC,"8/3/2017 5 p.m. PDT",4210,4341,2722,-1488
BANC,"8/3/2017 6 p.m. PDT",4070,4358,2525,-1545
BANC,"8/3/2017 7 p.m. PDT",3875,4249,2447,-1428
BANC,"8/3/2017 8 p.m. PDT",3616,4048,2337,-1279
BANC,"8/3/2017 9 p.m. PDT",3397,3762,2324,-1073
BANC,"8/3/2017 10 p.m. PDT",3199,3475,2239,-960
BANC,"8/3/2017 11 p.m. PDT",2901,3026,1655,-1246
BANC,"8/4/2017 12 a.m. PDT",2609,2629,1630,-979
BANC,"8/4/2017 1 a.m. PDT",2393,2418,1559,-834
BANC,"8/4/2017 2 a.m. PDT",2236,2205,1431,-805
BANC,"8/4/2017 3 a.m. PDT",2126,2071,1369,-757
BANC,"8/4/2017 4 a.m. PDT",2074,1986,1324,-750
BANC,"8/4/2017 5 a.m. PDT",2067,1954,1319,-748
BANC,"8/4/2017 6 a.m. PDT",2167,2022,1414,-753
BANC,"8/4/2017 7 a.m. PDT",2261,2090,1843,-418
BANC,"8/4/2017 8 a.m. PDT",2383,2195,1826,-557
BANC,"8/4/2017 9 a.m. PDT",2526,2317,1890,-636
BANC,"8/4/2017 10 a.m. PDT",2710,2493,1986,-724
BANC,"8/4/2017 11 a.m. PDT",2953,2728,1962,-991
BANC,"8/4/2017 12 p.m. PDT",3158,3025,2048,-1110
BANC,"8/4/2017 1 p.m. PDT",3384,3303,2050,-1334
BANC,"8/4/2017 2 p.m. PDT",3568,3586,1992,-1576
BANC,"8/4/2017 3 p.m. PDT",3699,3857,2133,-1566
BANC,"8/4/2017 4 p.m. PDT",3742,4088,2308,-1434
BANC,"8/4/2017 5 p.m. PDT",3725,4184,2345,-1380
BANC,"8/4/2017 6 p.m. PDT",3597,4181,2267,-1330
BANC,"8/4/2017 7 p.m. PDT",3376,4042,2032,-1344
BANC,"8/4/2017 8 p.m. PDT",3170,3812,2100,-1070
BANC,"8/4/2017 9 p.m. PDT",3072,3557,2199,-873
BANC,"8/4/2017 10 p.m. PDT",2925,3252,2027,-898
BANC,"8/4/2017 11 p.m. PDT",2676,2889,1647,-1029
BANC,"8/5/2017 12 a.m. PDT",2454,2556,1546,-908
BANC,"8/5/2017 1 a.m. PDT",2249,2366,1320,-929
BANC,"8/5/2017 2 a.m. PDT",2108,2149,1254,-854
BANC,"8/5/2017 3 a.m. PDT",2002,2032,1224,-778
BANC,"8/5/2017 4 a.m. PDT",1938,1879,1194,-744
BANC,"8/5/2017 5 a.m. PDT",1899,1839,1165,-734
BANC,"8/5/2017 6 a.m. PDT",1907,1805,1167,-740
BANC,"8/5/2017 7 a.m. PDT",1910,1795,1316,-594
BANC,"8/5/2017 8 a.m. PDT",1934,1875,1278,-656
BANC,"8/5/2017 9 a.m. PDT",2012,2001,1411,-601
BANC,"8/5/2017 10 a.m. PDT",2100,2186,1421,-679
BANC,"8/5/2017 11 a.m. PDT",2293,2387,1450,-843
BANC,"8/5/2017 12 p.m. PDT",2495,2613,1612,-883
BANC,"8/5/2017 1 p.m. PDT",2720,2869,1702,-1018
BANC,"8/5/2017 2 p.m. PDT",2959,3139,1902,-1057
BANC,"8/5/2017 3 p.m. PDT",3205,3398,2002,-1203
BANC,"8/5/2017 4 p.m. PDT",3409,3637,2105,-1304
BANC,"8/5/2017 5 p.m. PDT",3547,3770,2410,-1137
BANC,"8/5/2017 6 p.m. PDT",3578,3821,2395,-1183
BANC,"8/5/2017 7 p.m. PDT",3484,3737,2360,-1124
BANC,"8/5/2017 8 p.m. PDT",3257,3536,2214,-1043
BANC,"8/5/2017 9 p.m. PDT",3059,3331,2180,-879
BANC,"8/5/2017 10 p.m. PDT",2834,3047,1808,-1026
BANC,"8/5/2017 11 p.m. PDT",2537,2711,1436,-1101
BANC,"8/6/2017 12 a.m. PDT",2261,2405,1449,-812
BANC,"8/6/2017 1 a.m. PDT",2056,2096,1445,-611
BANC,"8/6/2017 2 a.m. PDT",1901,1941,1317,-584
BANC,"8/6/2017 3 a.m. PDT",1798,1834,1179,-619
BANC,"8/6/2017 4 a.m. PDT",1730,1750,1125,-605
BANC,"8/6/2017 5 a.m. PDT",1699,1715,1078,-621
BANC,"8/6/2017 6 a.m. PDT",1689,1709,1046,-643
BANC,"8/6/2017 7 a.m. PDT",1661,1703,1357,-304
BANC,"8/6/2017 8 a.m. PDT",1695,1738,1308,-387
BANC,"8/6/2017 9 a.m. PDT",1793,1859,1387,-406
BANC,"8/6/2017 10 a.m. PDT",1922,2002,1499,-423
BANC,"8/6/2017 11 a.m. PDT",2056,2190,1649,-407
BANC,"8/6/2017 12 p.m. PDT",2233,2397,1756,-477
BANC,"8/6/2017 1 p.m. PDT",2423,2613,1931,-492
BANC,"8/6/2017 2 p.m. PDT",2660,2874,1983,-677
BANC,"8/6/2017 3 p.m. PDT",2896,3139,2232,-664
BANC,"8/6/2017 4 p.m. PDT",3126,3367,2425,-701
BANC,"8/6/2017 5 p.m. PDT",3296,3517,2540,-756
BANC,"8/6/2017 6 p.m. PDT",3363,3611,2598,-765
BANC,"8/6/2017 7 p.m. PDT",3272,3535,2505,-767
BANC,"8/6/2017 8 p.m. PDT",3035,3334,2333,-702
BANC,"8/6/2017 9 p.m. PDT",2822,3121,2295,-527
BANC,"8/6/2017 10 p.m. PDT",2607,2884,2066,-541
BANC,"8/6/2017 11 p.m. PDT",2326,2558,1605,-721
BANC,"8/7/2017 12 a.m. PDT",2064,2269,1429,-635
BANC,"8/7/2017 1 a.m. PDT",1888,2100,1317,-571
BANC,"8/7/2017 2 a.m. PDT",1767,1933,1239,-528
BANC,"8/7/2017 3 a.m. PDT",1703,1836,1126,-577
BANC,"8/7/2017 4 a.m. PDT",1671,1775,1089,-582
BANC,"8/7/2017 5 a.m. PDT",1700,1773,1057,-643
BANC,"8/7/2017 6 a.m. PDT",1783,1825,1209,-574
BANC,"8/7/2017 7 a.m. PDT",1873,1898,1500,-373
BANC,"8/7/2017 8 a.m. PDT",1980,1987,1596,-384
BANC,"8/7/2017 9 a.m. PDT",2098,2099,1680,-418
BANC,"8/7/2017 10 a.m. PDT",2203,2237,1706,-497
BANC,"8/7/2017 11 a.m. PDT",2334,2403,1685,-649
BANC,"8/7/2017 12 p.m. PDT",2487,2586,1803,-684
BANC,"8/7/2017 1 p.m. PDT",2682,2798,1859,-823
BANC,"8/7/2017 2 p.m. PDT",2892,3059,1970,-922
BANC,"8/7/2017 3 p.m. PDT",3144,3319,2129,-1015
BANC,"8/7/2017 4 p.m. PDT",3355,3548,2246,-1109
BANC,"8/7/2017 5 p.m. PDT",3534,3722,2346,-1188
BANC,"8/7/2017 6 p.m. PDT",3567,3763,2511,-1056
BANC,"8/7/2017 7 p.m. PDT",3479,3655,2388,-1091
BANC,"8/7/2017 8 p.m. PDT",3244,3440,2269,-975
BANC,"8/7/2017 9 p.m. PDT",3012,3223,2143,-869
BANC,"8/7/2017 10 p.m. PDT",2761,2956,1906,-855
BANC,"8/7/2017 11 p.m. PDT",2448,2599,1488,-960
BANC,"8/8/2017 12 a.m. PDT",2167,2314,1463,-704
BANC,"8/8/2017 1 a.m. PDT",1971,2056,1275,-696
BANC,"8/8/2017 2 a.m. PDT",1847,1905,1147,-700
BANC,"8/8/2017 3 a.m. PDT",1776,1818,1097,-679
BANC,"8/8/2017 4 a.m. PDT",1722,1763,1082,-640
BANC,"8/8/2017 5 a.m. PDT",1744,1774,1035,-709
BANC,"8/8/2017 6 a.m. PDT",1812,1848,1131,-681
BANC,"8/8/2017 7 a.m. PDT",1907,1951,1389,-518
BANC,"8/8/2017 8 a.m. PDT",1996,2033,1531,-465
BANC,"8/8/2017 9 a.m. PDT",2092,2145,1439,-653
BANC,"8/8/2017 10 a.m. PDT",2206,2274,1488,-718
BANC,"8/8/2017 11 a.m. PDT",2353,2430,1656,-697
BANC,"8/8/2017 12 p.m. PDT",2517,2596,1792,-725
BANC,"8/8/2017 1 p.m. PDT",2733,2797,1850,-883
BANC,"8/8/2017 2 p.m. PDT",2945,3058,1957,-988
BANC,"8/8/2017 3 p.m. PDT",3221,3314,2180,-1041
BANC,"8/8/2017 4 p.m. PDT",3461,3550,2402,-1059
BANC,"8/8/2017 5 p.m. PDT",3656,3729,2591,-1065
BANC,"8/8/2017 6 p.m. PDT",3724,3783,2704,-1020
BANC,"8/8/2017 7 p.m. PDT",3629,3653,2541,-1088
BANC,"8/8/2017 8 p.m. PDT",3403,3444,2373,-1030
BANC,"8/8/2017 9 p.m. PDT",3157,3239,2121,-1036
BANC,"8/8/2017 10 p.m. PDT",2881,2964,2060,-821
BANC,"8/8/2017 11 p.m. PDT",2519,2615,1585,-934
BANC,"8/9/2017 12 a.m. PDT",2216,2298,1373,-843
BANC,"8/9/2017 1 a.m. PDT",2002,2045,1304,-698
BANC,"8/9/2017 2 a.m. PDT",1858,1899,1132,-726
BANC,"8/9/2017 3 a.m. PDT",1772,1808,1079,-693
BANC,"8/9/2017 4 a.m. PDT",1732,1760,1037,-695
BANC,"8/9/2017 5 a.m. PDT",1732,1755,1056,-676
BANC,"8/9/2017 6 a.m. PDT",1803,1840,1157,-646
BANC,"8/9/2017 7 a.m. PDT",1896,1931,1381,-515
BANC,"8/9/2017 8 a.m. PDT",1990,2022,1485,-505
BANC,"8/9/2017 9 a.m. PDT",2081,2123,1571,-510
BANC,"8/9/2017 10 a.m. PDT",2189,2245,1666,-523
BANC,"8/9/2017 11 a.m. PDT",2324,2404,1949,-375
BANC,"8/9/2017 12 p.m. PDT",2486,2588,1853,-633
BANC,"8/9/2017 1 p.m. PDT",2675,2809,1870,-805
BANC,"8/9/2017 2 p.m. PDT",2895,3075,2002,-893
BANC,"8/9/2017 3 p.m. PDT",3131,3334,2219,-912
BANC,"8/9/2017 4 p.m. PDT",3325,3550,2361,-964
BANC,"8/9/2017 5 p.m. PDT",3497,3712,2488,-1009
BANC,"8/9/2017 6 p.m. PDT",3542,3760,2513,-1029
BANC,"8/9/2017 7 p.m. PDT",3443,3631,2521,-922
BANC,"8/9/2017 8 p.m. PDT",3194,3419,2368,-826
BANC,"8/9/2017 9 p.m. PDT",3003,3242,2318,-685
BANC,"8/9/2017 10 p.m. PDT",2732,2979,2108,-624
BANC,"8/9/2017 11 p.m. PDT",2401,2621,1557,-844
BANC,"8/10/2017 12 a.m. PDT",2143,2293,1454,-689
BANC,"8/10/2017 1 a.m. PDT",1939,2049,1145,-794
BANC,"8/10/2017 2 a.m. PDT",1828,1903,1055,-773
BANC,"8/10/2017 3 a.m. PDT",1751,1814,988,-763
BANC,"8/10/2017 4 a.m. PDT",1714,1769,961,-753
BANC,"8/10/2017 5 a.m. PDT",1725,1773,965,-760
BANC,"8/10/2017 6 a.m. PDT",1811,1851,1032,-779
BANC,"8/10/2017 7 a.m. PDT",1922,1944,1309,-613
BANC,"8/10/2017 8 a.m. PDT",2000,2033,1377,-623
BANC,"8/10/2017 9 a.m. PDT",2080,2129,1388,-692
BANC,"8/10/2017 10 a.m. PDT",2167,2240,1373,-794
BANC,"8/10/2017 11 a.m. PDT",2310,2393,1579,-731
BANC,"8/10/2017 12 p.m. PDT",2470,2569,1737,-733
BANC,"8/10/2017 1 p.m. PDT",2648,2780,1757,-891
BANC,"8/10/2017 2 p.m. PDT",2881,3029,1927,-954
BANC,"8/10/2017 3 p.m. PDT",3143,3298,2201,-942
BANC,"8/10/2017 4 p.m. PDT",3414,3518,2250,-1164
BANC,"8/10/2017 5 p.m. PDT",3599,3700,2329,-1270
BANC,"8/10/2017 6 p.m. PDT",3676,3773,2391,-1285
BANC,"8/10/2017 7 p.m. PDT",3601,3641,2360,-1241
BANC,"8/10/2017 8 p.m. PDT",3404,3424,2300,-1104
BANC,"8/10/2017 9 p.m. PDT",3201,3233,2278,-923
BANC,"8/10/2017 10 p.m. PDT",2930,2965,2103,-827
BANC,"8/10/2017 11 p.m. PDT",2574,2603,1655,-919
BANC,"8/11/2017 12 a.m. PDT",2256,2285,1364,-892
BANC,"8/11/2017 1 a.m. PDT",2035,2041,1279,-756
BANC,"8/11/2017 2 a.m. PDT",1898,1897,1078,-820
BANC,"8/11/2017 3 a.m. PDT",1804,1798,988,-816
BANC,"8/11/2017 4 a.m. PDT",1748,1753,944,-804
BANC,"8/11/2017 5 a.m. PDT",1765,1758,957,-808
BANC,"8/11/2017 6 a.m. PDT",1839,1832,1090,-749
BANC,"8/11/2017 7 a.m. PDT",1939,1924,1404,-535
BANC,"8/11/2017 8 a.m. PDT",2034,2012,1487,-547
BANC,"8/11/2017 9 a.m. PDT",2125,2114,1491,-634
BANC,"8/11/2017 10 a.m. PDT",2251,2238,1540,-711
BANC,"8/11/2017 11 a.m. PDT",2405,2390,1634,-771
BANC,"8/11/2017 12 p.m. PDT",2590,2587,1871,-719
BANC,"8/11/2017 1 p.m. PDT",2818,2804,1928,-890
BANC,"8/11/2017 2 p.m. PDT",3104,3086,2075,-1029
BANC,"8/11/2017 3 p.m. PDT",3368,3363,2380,-988
BANC,"8/11/2017 4 p.m. PDT",3646,3587,2490,-1156
BANC,"8/11/2017 5 p.m. PDT",3849,3761,2516,-1333
BANC,"8/11/2017 6 p.m. PDT",3897,3805,2661,-1236
BANC,"8/11/2017 7 p.m. PDT",3769,3663,2585,-1184
BANC,"8/11/2017 8 p.m. PDT",3571,3435,2556,-1015
BANC,"8/11/2017 9 p.m. PDT",3356,3261,2449,-907
BANC,"8/11/2017 10 p.m. PDT",3088,2982,2178,-910
BANC,"8/11/2017 11 p.m. PDT",2738,2641,1739,-999
BANC,"8/12/2017 12 a.m. PDT",2418,2322,1479,-939
BANC,"8/12/2017 1 a.m. PDT",2173,2030,1336,-837
BANC,"8/12/2017 2 a.m. PDT",2012,1888,1125,-887
BANC,"8/12/2017 3 a.m. PDT",1883,1770,1046,-837
BANC,"8/12/2017 4 a.m. PDT",1820,1704,1009,-811
BANC,"8/12/2017 5 a.m. PDT",1772,1672,1006,-766
BANC,"8/12/2017 6 a.m. PDT",1786,1687,1042,-744
BANC,"8/12/2017 7 a.m. PDT",1786,1698,1365,-421
BANC,"8/12/2017 8 a.m. PDT",1840,1756,1316,-524
BANC,"8/12/2017 9 a.m. PDT",1951,1872,1379,-572
BANC,"8/12/2017 10 a.m. PDT",2101,2013,1504,-597
BANC,"8/12/2017 11 a.m. PDT",2293,2182,1648,-645
BANC,"8/12/2017 12 p.m. PDT",2492,2371,1888,-604
BANC,"8/12/2017 1 p.m. PDT",2713,2552,1877,-836
BANC,"8/12/2017 2 p.m. PDT",2959,2784,2055,-904
BANC,"8/12/2017 3 p.m. PDT",3207,3027,2258,-949
BANC,"8/12/2017 4 p.m. PDT",3428,3238,2463,-965
BANC,"8/12/2017 5 p.m. PDT",3561,3411,2568,-993
BANC,"8/12/2017 6 p.m. PDT",3605,3472,2615,-990
BANC,"8/12/2017 7 p.m. PDT",3490,3381,2576,-914
BANC,"8/12/2017 8 p.m. PDT",3240,3163,2472,-768
BANC,"8/12/2017 9 p.m. PDT",3009,3004,2371,-638
BANC,"8/12/2017 10 p.m. PDT",2754,2785,2215,-539
BANC,"8/12/2017 11 p.m. PDT",2442,2488,1531,-911
BANC,"8/13/2017 12 a.m. PDT",2181,2225,1368,-813
BANC,"8/13/2017 1 a.m. PDT",1982,2026,1261,-721
BANC,"8/13/2017 2 a.m. PDT",1846,1873,1137,-709
BANC,"8/13/2017 3 a.m. PDT",1754,1783,1070,-684
BANC,"8/13/2017 4 a.m. PDT",1705,1700,1026,-679
BANC,"8/13/2017 5 a.m. PDT",1672,1668,995,-677
BANC,"8/13/2017 6 a.m. PDT",1672,1670,993,-679
BANC,"8/13/2017 7 a.m. PDT",1659,1655,1123,-536
BANC,"8/13/2017 8 a.m. PDT",1691,1686,1133,-558
BANC,"8/13/2017 9 a.m. PDT",1788,1780,1189,-599
BANC,"8/13/2017 10 a.m. PDT",1905,1891,1270,-635
BANC,"8/13/2017 11 a.m. PDT",2036,2031,1471,-565
BANC,"8/13/2017 12 p.m. PDT",2200,2214,1601,-599
BANC,"8/13/2017 1 p.m. PDT",2403,2371,1798,-605
BANC,"8/13/2017 2 p.m. PDT",2636,2608,2003,-633
BANC,"8/13/2017 3 p.m. PDT",2887,2833,2226,-661
BANC,"8/13/2017 4 p.m. PDT",3115,3044,2182,-933
BANC,"8/13/2017 5 p.m. PDT",3266,3200,2310,-956
BANC,"8/13/2017 6 p.m. PDT",3293,3275,2425,-868
BANC,"8/13/2017 7 p.m. PDT",3189,3210,2375,-814
BANC,"8/13/2017 8 p.m. PDT",2960,2976,2300,-660
BANC,"8/13/2017 9 p.m. PDT",2790,2813,2204,-586
BANC,"8/13/2017 10 p.m. PDT",2602,2618,2181,-421
BANC,"8/13/2017 11 p.m. PDT",2323,2330,1583,-740
BANC,"8/14/2017 12 a.m. PDT",2078,2080,1296,-782
BANC,"8/14/2017 1 a.m. PDT",1901,1862,1251,-650
BANC,"8/14/2017 2 a.m. PDT",1793,1754,1168,-625
BANC,"8/14/2017 3 a.m. PDT",1731,1688,1096,-635
BANC,"8/14/2017 4 a.m. PDT",1710,1657,1074,-636
BANC,"8/14/2017 5 a.m. PDT",1740,1677,1098,-642
BANC,"8/14/2017 6 a.m. PDT",1830,1733,1203,-627
BANC,"8/14/2017 7 a.m. PDT",1957,1856,1622,-335
BANC,"8/14/2017 8 a.m. PDT",2042,1919,1619,-423
BANC,"8/14/2017 9 a.m. PDT",2077,2021,1598,-479
BANC,"8/14/2017 10 a.m. PDT",2178,2117,1690,-488
BANC,"8/14/2017 11 a.m. PDT",2277,2230,1748,-529
BANC,"8/14/2017 12 p.m. PDT",2364,2347,1825,-539
BANC,"8/14/2017 1 p.m. PDT",2503,2470,1843,-660
BANC,"8/14/2017 2 p.m. PDT",2633,2633,1927,-706
BANC,"8/14/2017 3 p.m. PDT",2766,2789,2070,-696
BANC,"8/14/2017 4 p.m. PDT",2877,2951,2024,-853
BANC,"8/14/2017 5 p.m. PDT",2990,3091,2138,-852
BANC,"8/14/2017 6 p.m. PDT",3006,3117,2198,-808
BANC,"8/14/2017 7 p.m. PDT",2898,2996,2335,-563
BANC,"8/14/2017 8 p.m. PDT",2683,2808,2185,-498
BANC,"8/14/2017 9 p.m. PDT",2573,2722,2215,-358
BANC,"8/14/2017 10 p.m. PDT",2412,2507,2158,-254
BANC,"8/14/2017 11 p.m. PDT",2163,2236,1604,-559
BANC,"8/15/2017 12 a.m. PDT",1948,2005,1384,-564
BANC,"8/15/2017 1 a.m. PDT",1795,1873,1191,-604
BANC,"8/15/2017 2 a.m. PDT",1708,1762,1005,-703
BANC,"8/15/2017 3 a.m. PDT",1661,1694,943,-718
BANC,"8/15/2017 4 a.m. PDT",1638,1660,915,-723
BANC,"8/15/2017 5 a.m. PDT",1670,1681,967,-703
BANC,"8/15/2017 6 a.m. PDT",1750,1762,1144,-606
BANC,"8/15/2017 7 a.m. PDT",1869,1881,1536,-333
BANC,"8/15/2017 8 a.m. PDT",1941,1958,1576,-365
BANC,"8/15/2017 9 a.m. PDT",1992,2030,1463,-529
BANC,"8/15/2017 10 a.m. PDT",2065,2119,1503,-562
BANC,"8/15/2017 11 a.m. PDT",2143,2221,1538,-605
BANC,"8/15/2017 12 p.m. PDT",2201,2331,1611,-590
BANC,"8/15/2017 1 p.m. PDT",2246,2457,1542,-704
BANC,"8/15/2017 2 p.m. PDT",2418,2629,1751,-667
BANC,"8/15/2017 3 p.m. PDT",2601,2781,1958,-643
BANC,"8/15/2017 4 p.m. PDT",2740,2943,2070,-670
BANC,"8/15/2017 5 p.m. PDT",2892,3075,2121,-771
BANC,"8/15/2017 6 p.m. PDT",2953,3109,2316,-637
BANC,"8/15/2017 7 p.m. PDT",2882,3012,2457,-425
BANC,"8/15/2017 8 p.m. PDT",2722,2858,2415,-307
BANC,"8/15/2017 9 p.m. PDT",2636,2765,2367,-269
BANC,"8/15/2017 10 p.m. PDT",2461,2555,2132,-329
BANC,"8/15/2017 11 p.m. PDT",2199,2285,1473,-726
BANC,"8/16/2017 12 a.m. PDT",1968,2044,1227,-741
BANC,"8/16/2017 1 a.m. PDT",1827,1921,1055,-772
BANC,"8/16/2017 2 a.m. PDT",1726,1804,1000,-726
BANC,"8/16/2017 3 a.m. PDT",1665,1736,961,-704
BANC,"8/16/2017 4 a.m. PDT",1651,1702,918,-733
BANC,"8/16/2017 5 a.m. PDT",1658,1724,906,-752
BANC,"8/16/2017 6 a.m. PDT",1759,1807,1011,-748
BANC,"8/16/2017 7 a.m. PDT",1892,1914,1616,-276
BANC,"8/16/2017 8 a.m. PDT",1951,1997,1539,-412
BANC,"8/16/2017 9 a.m. PDT",2000,2094,1479,-521
BANC,"8/16/2017 10 a.m. PDT",2079,2184,1512,-567
BANC,"8/16/2017 11 a.m. PDT",2174,2297,1593,-581
BANC,"8/16/2017 12 p.m. PDT",2281,2438,1704,-577
BANC,"8/16/2017 1 p.m. PDT",2401,2598,1737,-664
BANC,"8/16/2017 2 p.m. PDT",2570,2807,1840,-730
BANC,"8/16/2017 3 p.m. PDT",2787,3017,1902,-885
BANC,"8/16/2017 4 p.m. PDT",2998,3207,2080,-918
BANC,"8/16/2017 5 p.m. PDT",3173,3368,2178,-995
BANC,"8/16/2017 6 p.m. PDT",3250,3424,2289,-961
BANC,"8/16/2017 7 p.m. PDT",3186,3318,2388,-798
BANC,"8/16/2017 8 p.m. PDT",3049,3123,2344,-705
BANC,"8/16/2017 9 p.m. PDT",2952,2986,2375,-577
BANC,"8/16/2017 10 p.m. PDT",2744,2744,2096,-648
BANC,"8/16/2017 11 p.m. PDT",2416,2440,1603,-813
BANC,"8/17/2017 12 a.m. PDT",2149,2171,1377,-772
BANC,"8/17/2017 1 a.m. PDT",1955,1948,1289,-666
BANC,"8/17/2017 2 a.m. PDT",1824,1825,1131,-693
BANC,"8/17/2017 3 a.m. PDT",1750,1753,1074,-676
BANC,"8/17/2017 4 a.m. PDT",1716,1713,1020,-696
BANC,"8/17/2017 5 a.m. PDT",1732,1730,1072,-660
BANC,"8/17/2017 6 a.m. PDT",1823,1814,1189,-634
BANC,"8/17/2017 7 a.m. PDT",1950,1917,1574,-376
BANC,"8/17/2017 8 a.m. PDT",2017,2006,1579,-438
BANC,"8/17/2017 9 a.m. PDT",2093,2091,1578,-515
BANC,"8/17/2017 10 a.m. PDT",2200,2194,1599,-601
BANC,"8/17/2017 11 a.m. PDT",2329,2328,1676,-653
BANC,"8/17/2017 12 p.m. PDT",2511,2484,1848,-663
BANC,"8/17/2017 1 p.m. PDT",2716,2669,1923,-793
BANC,"8/17/2017 2 p.m. PDT",2956,2905,2045,-911
BANC,"8/17/2017 3 p.m. PDT",3228,3142,2270,-958
BANC,"8/17/2017 4 p.m. PDT",3483,3380,2392,-1091
BANC,"8/17/2017 5 p.m. PDT",3641,3551,2656,-985
BANC,"8/17/2017 6 p.m. PDT",3686,3609,2707,-979
BANC,"8/17/2017 7 p.m. PDT",3562,3496,2725,-837
BANC,"8/17/2017 8 p.m. PDT",3343,3291,2565,-778
BANC,"8/17/2017 9 p.m. PDT",3168,3135,2514,-654
BANC,"8/17/2017 10 p.m. PDT",2897,2874,2383,-514
BANC,"8/17/2017 11 p.m. PDT",2537,2541,1854,-683
BANC,"8/18/2017 12 a.m. PDT",2225,2244,1518,-707
BANC,"8/18/2017 1 a.m. PDT",2024,1977,1354,-670
BANC,"8/18/2017 2 a.m. PDT",1886,1850,1238,-648
BANC,"8/18/2017 3 a.m. PDT",1797,1771,1149,-648
BANC,"8/18/2017 4 a.m. PDT",1747,1732,1098,-649
BANC,"8/18/2017 5 a.m. PDT",1759,1744,1086,-673
BANC,"8/18/2017 6 a.m. PDT",1844,1830,1177,-667
BANC,"8/18/2017 7 a.m. PDT",1949,1925,1536,-413
BANC,"8/18/2017 8 a.m. PDT",2032,2015,1517,-515
BANC,"8/18/2017 9 a.m. PDT",2088,2093,1571,-517
BANC,"8/18/2017 10 a.m. PDT",2214,2207,1676,-538
BANC,"8/18/2017 11 a.m. PDT",2324,2356,1810,-514
BANC,"8/18/2017 12 p.m. PDT",2483,2510,1928,-555
BANC,"8/18/2017 1 p.m. PDT",2686,2696,1896,-790
BANC,"8/18/2017 2 p.m. PDT",2948,2943,2083,-865
BANC,"8/18/2017 3 p.m. PDT",3186,3188,2357,-829
BANC,"8/18/2017 4 p.m. PDT",3504,3428,2601,-903
BANC,"8/18/2017 5 p.m. PDT",3705,3600,2660,-1045
BANC,"8/18/2017 6 p.m. PDT",3775,3658,2722,-1053
BANC,"8/18/2017 7 p.m. PDT",3645,3541,2652,-993
BANC,"8/18/2017 8 p.m. PDT",3409,3336,2536,-873
BANC,"8/18/2017 9 p.m. PDT",3237,3158,2510,-727
BANC,"8/18/2017 10 p.m. PDT",2952,2892,2286,-666
BANC,"8/18/2017 11 p.m. PDT",2623,2557,1818,-805
BANC,"8/19/2017 12 a.m. PDT",2321,2258,1629,-692
BANC,"8/19/2017 1 a.m. PDT",2093,1987,1416,-677
BANC,"8/19/2017 2 a.m. PDT",1920,1848,1200,-720
BANC,"8/19/2017 3 a.m. PDT",1819,1750,1194,-625
BANC,"8/19/2017 4 a.m. PDT",1748,1696,1175,-573
BANC,"8/19/2017 5 a.m. PDT",1714,1678,1160,-554
BANC,"8/19/2017 6 a.m. PDT",1731,1698,1179,-552
BANC,"8/19/2017 7 a.m. PDT",1746,1710,1485,-261
BANC,"8/19/2017 8 a.m. PDT",1780,1777,1515,-265
BANC,"8/19/2017 9 a.m. PDT",1880,1896,1547,-333
BANC,"8/19/2017 10 a.m. PDT",2022,2035,1455,-567
BANC,"8/19/2017 11 a.m. PDT",2165,2198,1552,-613
BANC,"8/19/2017 12 p.m. PDT",2328,2387,1681,-647
BANC,"8/19/2017 1 p.m. PDT",2539,2580,1817,-722
BANC,"8/19/2017 2 p.m. PDT",2755,2821,1977,-778
BANC,"8/19/2017 3 p.m. PDT",3011,3061,2175,-836
BANC,"8/19/2017 4 p.m. PDT",3237,3289,2360,-877
BANC,"8/19/2017 5 p.m. PDT",3410,3445,2512,-898
BANC,"8/19/2017 6 p.m. PDT",3439,3487,2525,-914
BANC,"8/19/2017 7 p.m. PDT",3301,3383,2485,-816
BANC,"8/19/2017 8 p.m. PDT",3065,3171,2441,-624
BANC,"8/19/2017 9 p.m. PDT",2881,2981,2379,-502
BANC,"8/19/2017 10 p.m. PDT",2649,2740,2129,-520
BANC,"8/19/2017 11 p.m. PDT",2366,2452,1555,-811
BANC,"8/20/2017 12 a.m. PDT",2119,2186,1511,-608
BANC,"8/20/2017 1 a.m. PDT",1932,2002,1424,-508
BANC,"8/20/2017 2 a.m. PDT",1797,1854,1103,-694
BANC,"8/20/2017 3 a.m. PDT",1716,1761,1059,-657
BANC,"8/20/2017 4 a.m. PDT",1661,1699,983,-678
BANC,"8/20/2017 5 a.m. PDT",1642,1669,946,-696
BANC,"8/20/2017 6 a.m. PDT",1647,1670,1005,-642
BANC,"8/20/2017 7 a.m. PDT",1658,1656,1284,-374
BANC,"8/20/2017 8 a.m. PDT",1671,1699,1299,-372
BANC,"8/20/2017 9 a.m. PDT",1758,1788,1331,-427
BANC,"8/20/2017 10 a.m. PDT",1874,1904,1339,-535
BANC,"8/20/2017 11 a.m. PDT",1987,2028,1457,-530
BANC,"8/20/2017 12 p.m. PDT",2123,2198,1542,-581
BANC,"8/20/2017 1 p.m. PDT",2281,2381,1714,-567
BANC,"8/20/2017 2 p.m. PDT",2480,2604,1845,-635
BANC,"8/20/2017 3 p.m. PDT",2696,2853,1990,-706
BANC,"8/20/2017 4 p.m. PDT",2885,3086,2179,-706
BANC,"8/20/2017 5 p.m. PDT",3084,3238,2244,-840
BANC,"8/20/2017 6 p.m. PDT",3173,3299,2319,-854
BANC,"8/20/2017 7 p.m. PDT",3106,3206,2353,-753
BANC,"8/20/2017 8 p.m. PDT",2937,2993,2366,-571
BANC,"8/20/2017 9 p.m. PDT",2840,2838,2382,-458
BANC,"8/20/2017 10 p.m. PDT",2638,2633,2378,-260
BANC,"8/20/2017 11 p.m. PDT",2330,2348,1944,-386
BANC,"8/21/2017 12 a.m. PDT",2084,2096,1659,-425
BANC,"8/21/2017 1 a.m. PDT",1890,1878,1480,-410
BANC,"8/21/2017 2 a.m. PDT",1769,1753,1372,-397
BANC,"8/21/2017 3 a.m. PDT",1704,1675,1294,-410
BANC,"8/21/2017 4 a.m. PDT",1679,1641,1194,-485
BANC,"8/21/2017 5 a.m. PDT",1710,1657,1225,-485
BANC,"8/21/2017 6 a.m. PDT",1799,1743,1354,-445
BANC,"8/21/2017 7 a.m. PDT",1948,1847,1972,24
BANC,"8/21/2017 8 a.m. PDT",2010,1956,1861,-149
BANC,"8/21/2017 9 a.m. PDT",2092,2056,1906,-186
BANC,"8/21/2017 10 a.m. PDT",2177,2241,1695,-482
BANC,"8/21/2017 11 a.m. PDT",2222,2384,1703,-519
BANC,"8/21/2017 12 p.m. PDT",2220,2490,1648,-572
BANC,"8/21/2017 1 p.m. PDT",2340,2613,1546,-794
BANC,"8/21/2017 2 p.m. PDT",2461,2845,1660,-801
BANC,"8/21/2017 3 p.m. PDT",2604,3063,1794,-810
BANC,"8/21/2017 4 p.m. PDT",2793,3258,1962,-831
BANC,"8/21/2017 5 p.m. PDT",2945,3363,2041,-904
BANC,"8/21/2017 6 p.m. PDT",2950,3394,2184,-766
BANC,"8/21/2017 7 p.m. PDT",2803,3281,2116,-687
BANC,"8/21/2017 8 p.m. PDT",2683,3101,2005,-678
BANC,"8/21/2017 9 p.m. PDT",2647,2956,2306,-341
BANC,"8/21/2017 10 p.m. PDT",2477,2739,2247,-230
BANC,"8/21/2017 11 p.m. PDT",2240,2443,1885,-355
BANC,"8/22/2017 12 a.m. PDT",2015,2157,1681,-334
BANC,"8/22/2017 1 a.m. PDT",1850,1942,1491,-359
BANC,"8/22/2017 2 a.m. PDT",1751,1807,1372,-379
BANC,"8/22/2017 3 a.m. PDT",1698,1742,1259,-439
BANC,"8/22/2017 4 a.m. PDT",1659,1714,1220,-439
BANC,"8/22/2017 5 a.m. PDT",1700,1723,1334,-366
BANC,"8/22/2017 6 a.m. PDT",1776,1808,1511,-265
BANC,"8/22/2017 7 a.m. PDT",1923,1944,1811,-112
BANC,"8/22/2017 8 a.m. PDT",1996,2020,1835,-161
BANC,"8/22/2017 9 a.m. PDT",2063,2099,1932,-131
BANC,"8/22/2017 10 a.m. PDT",2151,2213,1877,-274
BANC,"8/22/2017 11 a.m. PDT",2247,2334,1853,-394
BANC,"8/22/2017 12 p.m. PDT",2386,2475,1978,-408
BANC,"8/22/2017 1 p.m. PDT",2568,2628,2002,-566
BANC,"8/22/2017 2 p.m. PDT",2799,2834,2272,-527
BANC,"8/22/2017 3 p.m. PDT",3036,3047,2364,-672
BANC,"8/22/2017 4 p.m. PDT",3276,3250,2374,-902
BANC,"8/22/2017 5 p.m. PDT",3478,3365,2552,-926
BANC,"8/22/2017 6 p.m. PDT",3592,3389,2620,-972
BANC,"8/22/2017 7 p.m. PDT",3525,3276,2540,-985
BANC,"8/22/2017 8 p.m. PDT",3361,3100,2415,-946
BANC,"8/22/2017 9 p.m. PDT",3206,2958,2421,-785
BANC,"8/22/2017 10 p.m. PDT",2901,2748,2279,-622
BANC,"8/22/2017 11 p.m. PDT",2559,2453,1960,-599
BANC,"8/23/2017 12 a.m. PDT",2251,2168,1676,-575
BANC,"8/23/2017 1 a.m. PDT",2038,1979,1256,-782
BANC,"8/23/2017 2 a.m. PDT",1895,1847,1143,-752
BANC,"8/23/2017 3 a.m. PDT",1809,1759,1135,-674
BANC,"8/23/2017 4 a.m. PDT",1758,1720,1055,-703
BANC,"8/23/2017 5 a.m. PDT",1773,1730,1111,-662
BANC,"8/23/2017 6 a.m. PDT",1856,1821,1149,-707
BANC,"8/23/2017 7 a.m. PDT",1986,1944,1883,-103
BANC,"8/23/2017 8 a.m. PDT",2058,2024,1868,-190
BANC,"8/23/2017 9 a.m. PDT",2125,2096,1748,-377
BANC,"8/23/2017 10 a.m. PDT",2275,2195,1789,-486
BANC,"8/23/2017 11 a.m. PDT",2420,2344,1901,-519
BANC,"8/23/2017 12 p.m. PDT",2603,2503,2056,-547
BANC,"8/23/2017 1 p.m. PDT",2867,2702,2084,-783
BANC,"8/23/2017 2 p.m. PDT",3173,2967,2196,-977
BANC,"8/23/2017 3 p.m. PDT",3488,3214,2391,-1097
BANC,"8/23/2017 4 p.m. PDT",3738,3430,2385,-1353
BANC,"8/23/2017 5 p.m. PDT",3895,3606,2600,-1295
BANC,"8/23/2017 6 p.m. PDT",3904,3646,2671,-1233
BANC,"8/23/2017 7 p.m. PDT",3779,3507,2735,-1044
BANC,"8/23/2017 8 p.m. PDT",3536,3298,2654,-882
BANC,"8/23/2017 9 p.m. PDT",3320,3228,2598,-722
BANC,"8/23/2017 10 p.m. PDT",2991,2938,2445,-546
BANC,"8/23/2017 11 p.m. PDT",2591,2572,1705,-886
BANC,"8/24/2017 12 a.m. PDT",2259,2244,1454,-805
BANC,"8/24/2017 1 a.m. PDT",2025,1996,1100,-925
BANC,"8/24/2017 2 a.m. PDT",1889,1856,940,-949
BANC,"8/24/2017 3 a.m. PDT",1789,1767,858,-931
BANC,"8/24/2017 4 a.m. PDT",1746,1733,763,-983
BANC,"8/24/2017 5 a.m. PDT",1745,1738,794,-951
BANC,"8/24/2017 6 a.m. PDT",1839,1821,967,-872
BANC,"8/24/2017 7 a.m. PDT",1972,1929,1576,-396
BANC,"8/24/2017 8 a.m. PDT",2034,2016,1581,-453
BANC,"8/24/2017 9 a.m. PDT",2104,2091,1501,-603
BANC,"8/24/2017 10 a.m. PDT",2196,2198,1578,-618
BANC,"8/24/2017 11 a.m. PDT",2327,2340,1703,-624
BANC,"8/24/2017 12 p.m. PDT",2471,2495,1896,-575
BANC,"8/24/2017 1 p.m. PDT",2645,2686,1886,-759
BANC,"8/24/2017 2 p.m. PDT",2878,2925,2019,-859
BANC,"8/24/2017 3 p.m. PDT",3101,3166,2060,-1041
BANC,"8/24/2017 4 p.m. PDT",3289,3403,2230,-1059
BANC,"8/24/2017 5 p.m. PDT",3424,3577,2291,-1133
BANC,"8/24/2017 6 p.m. PDT",3445,3646,2342,-1103
BANC,"8/24/2017 7 p.m. PDT",3330,3535,2492,-838
BANC,"8/24/2017 8 p.m. PDT",3113,3330,2373,-740
BANC,"8/24/2017 9 p.m. PDT",2956,3158,2184,-772
BANC,"8/24/2017 10 p.m. PDT",2715,2878,2199,-516
BANC,"8/24/2017 11 p.m. PDT",2399,2537,1473,-926
BANC,"8/25/2017 12 a.m. PDT",2104,2229,1212,-892
BANC,"8/25/2017 1 a.m. PDT",1910,1982,1286,-624
BANC,"8/25/2017 2 a.m. PDT",1794,1849,1212,-582
BANC,"8/25/2017 3 a.m. PDT",1720,1763,1118,-602
BANC,"8/25/2017 4 a.m. PDT",1683,1726,1084,-599
BANC,"8/25/2017 5 a.m. PDT",1704,1736,1118,-586
BANC,"8/25/2017 6 a.m. PDT",1776,1817,1282,-494
BANC,"8/25/2017 7 a.m. PDT",1913,1939,1593,-320
BANC,"8/25/2017 8 a.m. PDT",1961,2012,1658,-303
BANC,"8/25/2017 9 a.m. PDT",2013,2083,1737,-276
BANC,"8/25/2017 10 a.m. PDT",2128,2195,1779,-349
BANC,"8/25/2017 11 a.m. PDT",2255,2332,1832,-423
BANC,"8/25/2017 12 p.m. PDT",2413,2491,1917,-496
BANC,"8/25/2017 1 p.m. PDT",2610,2687,1996,-614
BANC,"8/25/2017 2 p.m. PDT",2869,2934,2061,-808
BANC,"8/25/2017 3 p.m. PDT",3128,3190,2198,-930
BANC,"8/25/2017 4 p.m. PDT",3386,3421,2283,-1103
BANC,"8/25/2017 5 p.m. PDT",3559,3591,2327,-1232
BANC,"8/25/2017 6 p.m. PDT",3637,3641,2521,-1116
BANC,"8/25/2017 7 p.m. PDT",3540,3505,2592,-948
BANC,"8/25/2017 8 p.m. PDT",3339,3284,2561,-778
BANC,"8/25/2017 9 p.m. PDT",3155,3117,2587,-568
BANC,"8/25/2017 10 p.m. PDT",2886,2842,2357,-529
BANC,"8/25/2017 11 p.m. PDT",2564,2520,1846,-718
BANC,"8/26/2017 12 a.m. PDT",2275,2235,1670,-605
BANC,"8/26/2017 1 a.m. PDT",2054,2054,1489,-565
BANC,"8/26/2017 2 a.m. PDT",1898,1898,1401,-497
BANC,"8/26/2017 3 a.m. PDT",1792,1789,1279,-513
BANC,"8/26/2017 4 a.m. PDT",1728,1730,1211,-517
BANC,"8/26/2017 5 a.m. PDT",1699,1703,1159,-540
BANC,"8/26/2017 6 a.m. PDT",1718,1711,1226,-492
BANC,"8/26/2017 7 a.m. PDT",1737,1720,1589,-148
BANC,"8/26/2017 8 a.m. PDT",1790,1774,1553,-237
BANC,"8/26/2017 9 a.m. PDT",1941,1882,1560,-381
BANC,"8/26/2017 10 a.m. PDT",2105,2024,1648,-457
BANC,"8/26/2017 11 a.m. PDT",2352,2208,1872,-480
BANC,"8/26/2017 12 p.m. PDT",2618,2430,2119,-499
BANC,"8/26/2017 1 p.m. PDT",2940,2687,2237,-703
BANC,"8/26/2017 2 p.m. PDT",3257,2974,2290,-967
BANC,"8/26/2017 3 p.m. PDT",3579,3248,2372,-1207
BANC,"8/26/2017 4 p.m. PDT",3819,3486,2410,-1409
BANC,"8/26/2017 5 p.m. PDT",4016,3656,2698,-1318
BANC,"8/26/2017 6 p.m. PDT",4064,3719,2746,-1318
BANC,"8/26/2017 7 p.m. PDT",3992,3626,2725,-1267
BANC,"8/26/2017 8 p.m. PDT",3764,3440,2581,-1183
BANC,"8/26/2017 9 p.m. PDT",3527,3255,2580,-947
BANC,"8/26/2017 10 p.m. PDT",3247,2983,2364,-883
BANC,"8/26/2017 11 p.m. PDT",2927,2663,1857,-1070
BANC,"8/27/2017 12 a.m. PDT",2635,2377,1803,-832
BANC,"8/27/2017 1 a.m. PDT",2365,2184,1665,-700
BANC,"8/27/2017 2 a.m. PDT",2179,2016,1369,-810
BANC,"8/27/2017 3 a.m. PDT",2044,1895,1296,-748
BANC,"8/27/2017 4 a.m. PDT",1945,1803,1214,-731
BANC,"8/27/2017 5 a.m. PDT",1895,1753,1160,-735
BANC,"8/27/2017 6 a.m. PDT",1879,1745,1153,-726
BANC,"8/27/2017 7 a.m. PDT",1775,1719,1267,-508
BANC,"8/27/2017 8 a.m. PDT",1803,1764,1241,-562
BANC,"8/27/2017 9 a.m. PDT",1975,1892,1351,-624
BANC,"8/27/2017 10 a.m. PDT",2221,2094,1467,-754
BANC,"8/27/2017 11 a.m. PDT",2523,2344,1667,-856
BANC,"8/27/2017 12 p.m. PDT",2853,2653,1942,-911
BANC,"8/27/2017 1 p.m. PDT",3177,2965,2172,-1005
BANC,"8/27/2017 2 p.m. PDT",3533,3280,2403,-1130
BANC,"8/27/2017 3 p.m. PDT",3818,3557,2512,-1306
BANC,"8/27/2017 4 p.m. PDT",4056,3798,2438,-1618
BANC,"8/27/2017 5 p.m. PDT",4223,3950,2780,-1443
BANC,"8/27/2017 6 p.m. PDT",4285,4049,2788,-1497
BANC,"8/27/2017 7 p.m. PDT",4224,3967,2973,-1251
BANC,"8/27/2017 8 p.m. PDT",4018,3799,2887,-1131
BANC,"8/27/2017 9 p.m. PDT",3826,3595,2928,-898
BANC,"8/27/2017 10 p.m. PDT",3505,3297,2658,-847
BANC,"8/27/2017 11 p.m. PDT",3073,2839,1871,-1202
BANC,"8/28/2017 12 a.m. PDT",2685,2500,1691,-994
BANC,"8/28/2017 1 a.m. PDT",2417,2342,1635,-782
BANC,"8/28/2017 2 a.m. PDT",2214,2130,1430,-784
BANC,"8/28/2017 3 a.m. PDT",2084,1980,1311,-773
BANC,"8/28/2017 4 a.m. PDT",2000,1902,1287,-713
BANC,"8/28/2017 5 a.m. PDT",1994,1895,1296,-698
BANC,"8/28/2017 6 a.m. PDT",2061,1968,1450,-611
BANC,"8/28/2017 7 a.m. PDT",2197,2078,1846,-351
BANC,"8/28/2017 8 a.m. PDT",2316,2185,1909,-407
BANC,"8/28/2017 9 a.m. PDT",2470,2330,1935,-535
BANC,"8/28/2017 10 a.m. PDT",2707,2538,2040,-667
BANC,"8/28/2017 11 a.m. PDT",2990,2762,2139,-851
BANC,"8/28/2017 12 p.m. PDT",3336,3068,2348,-988
BANC,"8/28/2017 1 p.m. PDT",3648,3411,2388,-1260
BANC,"8/28/2017 2 p.m. PDT",4015,3731,2480,-1535
BANC,"8/28/2017 3 p.m. PDT",4318,4017,2564,-1754
BANC,"8/28/2017 4 p.m. PDT",4543,4241,2650,-1893
BANC,"8/28/2017 5 p.m. PDT",4677,4370,2948,-1729
BANC,"8/28/2017 6 p.m. PDT",4693,4393,2975,-1718
BANC,"8/28/2017 7 p.m. PDT",4598,4275,3265,-1333
BANC,"8/28/2017 8 p.m. PDT",4372,4047,2902,-1470
BANC,"8/28/2017 9 p.m. PDT",4136,3834,2755,-1381
BANC,"8/28/2017 10 p.m. PDT",3754,3486,2701,-1053
BANC,"8/28/2017 11 p.m. PDT",3284,3038,2053,-1231
BANC,"8/29/2017 12 a.m. PDT",2862,2654,1900,-962
BANC,"8/29/2017 1 a.m. PDT",2546,2460,1659,-887
BANC,"8/29/2017 2 a.m. PDT",2348,2249,1616,-732
BANC,"8/29/2017 3 a.m. PDT",2167,2090,1423,-744
BANC,"8/29/2017 4 a.m. PDT",2073,2001,1313,-760
BANC,"8/29/2017 5 a.m. PDT",2053,1981,1303,-750
BANC,"8/29/2017 6 a.m. PDT",2110,2049,1381,-729
BANC,"8/29/2017 7 a.m. PDT",2237,2163,1844,-393
BANC,"8/29/2017 8 a.m. PDT",2308,2269,1789,-519
BANC,"8/29/2017 9 a.m. PDT",2418,2403,1795,-623
BANC,"8/29/2017 10 a.m. PDT",2566,2600,1816,-750
BANC,"8/29/2017 11 a.m. PDT",2763,2847,1874,-889
BANC,"8/29/2017 12 p.m. PDT",3023,3127,2041,-982
BANC,"8/29/2017 1 p.m. PDT",3282,3422,2099,-1183
BANC,"8/29/2017 2 p.m. PDT",3596,3725,2302,-1294
BANC,"8/29/2017 3 p.m. PDT",3882,3987,2511,-1371
BANC,"8/29/2017 4 p.m. PDT",4084,4208,2595,-1489
BANC,"8/29/2017 5 p.m. PDT",4193,4328,2745,-1448
BANC,"8/29/2017 6 p.m. PDT",4210,4344,2808,-1402
BANC,"8/29/2017 7 p.m. PDT",4031,4189,2799,-1232
BANC,"8/29/2017 8 p.m. PDT",3752,3952,2700,-1052
BANC,"8/29/2017 9 p.m. PDT",3518,3709,2492,-1026
BANC,"8/29/2017 10 p.m. PDT",3157,3386,2375,-782
BANC,"8/29/2017 11 p.m. PDT",2731,2973,1703,-1028
BANC,"8/30/2017 12 a.m. PDT",2402,2599,1476,-926
BANC,"8/30/2017 1 a.m. PDT",2171,2265,1390,-781
BANC,"8/30/2017 2 a.m. PDT",2012,2097,1270,-742
BANC,"8/30/2017 3 a.m. PDT",1914,1979,1151,-763
BANC,"8/30/2017 4 a.m. PDT",1844,1909,1083,-761
BANC,"8/30/2017 5 a.m. PDT",1853,1898,1093,-760
BANC,"8/30/2017 6 a.m. PDT",1929,1972,1247,-682
BANC,"8/30/2017 7 a.m. PDT",2064,2082,1427,-637
BANC,"8/30/2017 8 a.m. PDT",2124,2173,1515,-609
BANC,"8/30/2017 9 a.m. PDT",2215,2304,1604,-611
BANC,"8/30/2017 10 a.m. PDT",2324,2466,1645,-679
BANC,"8/30/2017 11 a.m. PDT",2476,2670,1783,-693
BANC,"8/30/2017 12 p.m. PDT",2664,2905,1861,-803
BANC,"8/30/2017 1 p.m. PDT",2910,3177,1842,-1068
BANC,"8/30/2017 2 p.m. PDT",3203,3479,1977,-1226
BANC,"8/30/2017 3 p.m. PDT",3478,3753,2149,-1329
BANC,"8/30/2017 4 p.m. PDT",3731,3967,2264,-1467
BANC,"8/30/2017 5 p.m. PDT",3904,4120,2422,-1482
BANC,"8/30/2017 6 p.m. PDT",3924,4183,2517,-1407
BANC,"8/30/2017 7 p.m. PDT",3789,4060,2673,-1116
BANC,"8/30/2017 8 p.m. PDT",3526,3847,2573,-953
BANC,"8/30/2017 9 p.m. PDT",3303,3616,2439,-864
BANC,"8/30/2017 10 p.m. PDT",2962,3295,1963,-999
BANC,"8/30/2017 11 p.m. PDT",2575,2898,1466,-1109
BANC,"8/31/2017 12 a.m. PDT",2250,2555,1428,-822
BANC,"8/31/2017 1 a.m. PDT",2031,2226,1324,-707
BANC,"8/31/2017 2 a.m. PDT",1892,2047,1203,-689
BANC,"8/31/2017 3 a.m. PDT",1801,1929,1110,-691
BANC,"8/31/2017 4 a.m. PDT",1763,1868,1013,-750
BANC,"8/31/2017 5 a.m. PDT",1773,1860,1051,-722
BANC,"8/31/2017 6 a.m. PDT",1857,1941,1170,-687
BANC,"8/31/2017 7 a.m. PDT",2002,2049,1377,-625
BANC,"8/31/2017 8 a.m. PDT",2066,2158,1494,-572
BANC,"8/31/2017 9 a.m. PDT",2164,2293,1556,-608
BANC,"8/31/2017 10 a.m. PDT",2276,2473,1532,-744
BANC,"8/31/2017 11 a.m. PDT",2438,2715,1693,-745
BANC,"8/31/2017 12 p.m. PDT",2612,2991,1797,-815
BANC,"8/31/2017 1 p.m. PDT",2841,3309,1822,-1019
BANC,"8/31/2017 2 p.m. PDT",3157,3636,1947,-1210
BANC,"8/31/2017 3 p.m. PDT",3455,3931,2069,-1386
BANC,"8/31/2017 4 p.m. PDT",3759,4170,2453,-1306
BANC,"8/31/2017 5 p.m. PDT",3942,4328,2507,-1435
BANC,"8/31/2017 6 p.m. PDT",4014,4372,2533,-1481
BANC,"8/31/2017 7 p.m. PDT",3900,4264,2598,-1302
BANC,"8/31/2017 8 p.m. PDT",3681,4024,2483,-1198
BANC,"8/31/2017 9 p.m. PDT",3465,3798,2181,-1284
BANC,"8/31/2017 10 p.m. PDT",3160,3481,2084,-1076
BANC,"8/31/2017 11 p.m. PDT",2795,3056,1718,-1077
BANC,"9/1/2017 12 a.m. PDT",2448,2691,1504,-944
