"BA Code","Timestamp (Hour Ending)","Demand (MWh)","Demand Forecast (MWh)","Net Generation (MWh)","Total Interchange (MWh)"
BANC,"8/1/2016 12 a.m. PDT",2132,2406,1313,-819
BANC,"8/1/2016 1 a.m. PDT",1912,1941,1338,-574
BANC,"8/1/2016 2 a.m. PDT",1773,1773,1274,-499
BANC,"8/1/2016 3 a.m. PDT",1679,1685,1212,-467
BANC,"8/1/2016 4 a.m. PDT",1641,1632,1173,-468
BANC,"8/1/2016 5 a.m. PDT",1649,1639,1216,-433
BANC,"8/1/2016 6 a.m. PDT",1714,1714,1253,-461
BANC,"8/1/2016 7 a.m. PDT",1798,1784,1456,-342
BANC,"8/1/2016 8 a.m. PDT",1899,1897,1531,-368
BANC,"8/1/2016 9 a.m. PDT",2006,2054,1603,-403
BANC,"8/1/2016 10 a.m. PDT",2137,2221,1673,-464
BANC,"8/1/2016 11 a.m. PDT",2269,2396,1808,-461
BANC,"8/1/2016 12 p.m. PDT",2433,2615,1983,-450
BANC,"8/1/2016 1 p.m. PDT",2633,2811,2004,-629
BANC,"8/1/2016 2 p.m. PDT",2893,3069,2445,-448
BANC,"8/1/2016 3 p.m. PDT",3114,3325,2585,-529
BANC,"8/1/2016 4 p.m. PDT",3307,3545,2558,-749
BANC,"8/1/2016 5 p.m. PDT",3452,3695,2697,-755
BANC,"8/1/2016 6 p.m. PDT",3490,3729,2720,-770
BANC,"8/1/2016 7 p.m. PDT",3389,3631,2677,-712
BANC,"8/1/2016 8 p.m. PDT",3180,3458,2535,-645
BANC,"8/1/2016 9 p.m. PDT",2976,3229,2221,-755
BANC,"8/1/2016 10 p.m. PDT",2726,2968,1986,-740
BANC,"8/1/2016 11 p.m. PDT",2404,2606,1739,-665
BANC,"8/2/2016 12 a.m. PDT",2108,2285,1419,-689
BANC,"8/2/2016 1 a.m. PDT",1899,1934,1355,-544
BANC,"8/2/2016 2 a.m. PDT",1754,1779,1247,-507
BANC,"8/2/2016 3 a.m. PDT",1665,1690,1176,-489
BANC,"8/2/2016 4 a.m. PDT",1624,1638,1150,-474
BANC,"8/2/2016 5 a.m. PDT",1637,1642,1190,-447
BANC,"8/2/2016 6 a.m. PDT",1719,1712,1270,-449
BANC,"8/2/2016 7 a.m. PDT",1792,1780,1435,-357
BANC,"8/2/2016 8 a.m. PDT",1894,1887,1545,-349
BANC,"8/2/2016 9 a.m. PDT",1989,2036,1521,-468
BANC,"8/2/2016 10 a.m. PDT",2104,2202,1647,-457
BANC,"8/2/2016 11 a.m. PDT",2234,2361,1759,-475
BANC,"8/2/2016 12 p.m. PDT",2387,2568,1849,-538
BANC,"8/2/2016 1 p.m. PDT",2577,2763,1899,-678
BANC,"8/2/2016 2 p.m. PDT",2807,2998,2273,-534
BANC,"8/2/2016 3 p.m. PDT",3076,3270,2426,-650
BANC,"8/2/2016 4 p.m. PDT",3329,3491,2604,-725
BANC,"8/2/2016 5 p.m. PDT",3534,3654,2769,-765
BANC,"8/2/2016 6 p.m. PDT",3649,3691,2842,-807
BANC,"8/2/2016 7 p.m. PDT",3588,3606,2822,-766
BANC,"8/2/2016 8 p.m. PDT",3420,3424,2691,-729
BANC,"8/2/2016 9 p.m. PDT",3219,3211,2357,-862
BANC,"8/2/2016 10 p.m. PDT",2984,2953,2196,-788
BANC,"8/2/2016 11 p.m. PDT",2615,2588,1982,-633
BANC,"8/3/2016 12 a.m. PDT",2284,2270,1688,-596
BANC,"8/3/2016 1 a.m. PDT",2036,1946,1557,-479
BANC,"8/3/2016 2 a.m. PDT",1870,1798,1402,-468
BANC,"8/3/2016 3 a.m. PDT",1763,1697,1318,-445
BANC,"8/3/2016 4 a.m. PDT",1707,1654,1262,-445
BANC,"8/3/2016 5 a.m. PDT",1720,1658,1292,-428
BANC,"8/3/2016 6 a.m. PDT",1800,1728,1415,-385
BANC,"8/3/2016 7 a.m. PDT",1858,1807,1523,-335
BANC,"8/3/2016 8 a.m. PDT",1972,1923,1619,-353
BANC,"8/3/2016 9 a.m. PDT",2093,2039,1635,-458
BANC,"8/3/2016 10 a.m. PDT",2260,2172,1861,-400
BANC,"8/3/2016 11 a.m. PDT",2456,2343,1951,-505
BANC,"8/3/2016 12 p.m. PDT",2700,2533,2035,-665
BANC,"8/3/2016 1 p.m. PDT",2982,2757,2197,-785
BANC,"8/3/2016 2 p.m. PDT",3293,3037,2516,-777
BANC,"8/3/2016 3 p.m. PDT",3577,3285,2764,-813
BANC,"8/3/2016 4 p.m. PDT",3816,3517,2836,-980
BANC,"8/3/2016 5 p.m. PDT",3973,3672,2785,-1188
BANC,"8/3/2016 6 p.m. PDT",4016,3714,2922,-1094
BANC,"8/3/2016 7 p.m. PDT",3861,3600,2801,-1060
BANC,"8/3/2016 8 p.m. PDT",3577,3389,2638,-939
BANC,"8/3/2016 9 p.m. PDT",3260,3184,2409,-851
BANC,"8/3/2016 10 p.m. PDT",2953,2907,2186,-767
BANC,"8/3/2016 11 p.m. PDT",2512,2548,1831,-681
BANC,"8/4/2016 12 a.m. PDT",2186,2230,1752,-434
BANC,"8/4/2016 1 a.m. PDT",1933,1960,1380,-553
BANC,"8/4/2016 2 a.m. PDT",1771,1811,1286,-485
BANC,"8/4/2016 3 a.m. PDT",1667,1713,1222,-445
BANC,"8/4/2016 4 a.m. PDT",1624,1657,1183,-441
BANC,"8/4/2016 5 a.m. PDT",1628,1671,1145,-483
BANC,"8/4/2016 6 a.m. PDT",1696,1744,1188,-508
BANC,"8/4/2016 7 a.m. PDT",1761,1852,1440,-321
BANC,"8/4/2016 8 a.m. PDT",1847,1922,1744,-103
BANC,"8/4/2016 9 a.m. PDT",1927,2013,1819,-108
BANC,"8/4/2016 10 a.m. PDT",2019,2098,1904,-115
BANC,"8/4/2016 11 a.m. PDT",2121,2230,1791,-330
BANC,"8/4/2016 12 p.m. PDT",2214,2361,1963,-251
BANC,"8/4/2016 1 p.m. PDT",2348,2517,2156,-192
BANC,"8/4/2016 2 p.m. PDT",2493,2700,2357,-136
BANC,"8/4/2016 3 p.m. PDT",2686,2909,2452,-234
BANC,"8/4/2016 4 p.m. PDT",2848,3090,2463,-385
BANC,"8/4/2016 5 p.m. PDT",2973,3255,2522,-451
BANC,"8/4/2016 6 p.m. PDT",2977,3273,2433,-544
BANC,"8/4/2016 7 p.m. PDT",2863,3133,2385,-478
BANC,"8/4/2016 8 p.m. PDT",2663,2917,2212,-451
BANC,"8/4/2016 9 p.m. PDT",2526,2765,2122,-404
BANC,"8/4/2016 10 p.m. PDT",2364,2552,1922,-442
BANC,"8/4/2016 11 p.m. PDT",2111,2262,1581,-530
BANC,"8/5/2016 12 a.m. PDT",1888,2008,1266,-622
BANC,"8/5/2016 1 a.m. PDT",1727,1851,1374,-353
BANC,"8/5/2016 2 a.m. PDT",1619,1714,1259,-360
BANC,"8/5/2016 3 a.m. PDT",1576,1623,1281,-295
BANC,"8/5/2016 4 a.m. PDT",1539,1589,1259,-280
BANC,"8/5/2016 5 a.m. PDT",1565,1605,1289,-276
BANC,"8/5/2016 6 a.m. PDT",1642,1677,1355,-287
BANC,"8/5/2016 7 a.m. PDT",1727,1751,1455,-272
BANC,"8/5/2016 8 a.m. PDT",1797,1833,1543,-254
BANC,"8/5/2016 9 a.m. PDT",1888,1931,1597,-291
BANC,"8/5/2016 10 a.m. PDT",1967,2031,1690,-277
BANC,"8/5/2016 11 a.m. PDT",2056,2150,1758,-298
BANC,"8/5/2016 12 p.m. PDT",2130,2272,1814,-316
BANC,"8/5/2016 1 p.m. PDT",2246,2415,1866,-380
BANC,"8/5/2016 2 p.m. PDT",2362,2591,2072,-290
BANC,"8/5/2016 3 p.m. PDT",2511,2787,2238,-273
BANC,"8/5/2016 4 p.m. PDT",2660,2964,2371,-289
BANC,"8/5/2016 5 p.m. PDT",2794,3125,2420,-374
BANC,"8/5/2016 6 p.m. PDT",2866,3184,2428,-438
BANC,"8/5/2016 7 p.m. PDT",2813,3095,2419,-394
BANC,"8/5/2016 8 p.m. PDT",2661,2914,2193,-468
BANC,"8/5/2016 9 p.m. PDT",2557,2773,2190,-367
BANC,"8/5/2016 10 p.m. PDT",2411,2577,1799,-612
BANC,"8/5/2016 11 p.m. PDT",2185,2294,1741,-444
BANC,"8/6/2016 12 a.m. PDT",1970,2036,1633,-337
BANC,"8/6/2016 1 a.m. PDT",1788,1819,1514,-274
BANC,"8/6/2016 2 a.m. PDT",1677,1689,1409,-268
BANC,"8/6/2016 3 a.m. PDT",1599,1601,1310,-289
BANC,"8/6/2016 4 a.m. PDT",1554,1552,1300,-254
BANC,"8/6/2016 5 a.m. PDT",1529,1542,1274,-255
BANC,"8/6/2016 6 a.m. PDT",1566,1568,1314,-252
BANC,"8/6/2016 7 a.m. PDT",1558,1575,1298,-260
BANC,"8/6/2016 8 a.m. PDT",1584,1625,1307,-277
BANC,"8/6/2016 9 a.m. PDT",1706,1750,1436,-270
BANC,"8/6/2016 10 a.m. PDT",1798,1876,1521,-277
BANC,"8/6/2016 11 a.m. PDT",1899,2003,1571,-328
BANC,"8/6/2016 12 p.m. PDT",2003,2133,1626,-377
BANC,"8/6/2016 1 p.m. PDT",2128,2276,1645,-483
BANC,"8/6/2016 2 p.m. PDT",2292,2433,1917,-375
BANC,"8/6/2016 3 p.m. PDT",2468,2642,2146,-322
BANC,"8/6/2016 4 p.m. PDT",2655,2838,2272,-383
BANC,"8/6/2016 5 p.m. PDT",2794,2986,2316,-478
BANC,"8/6/2016 6 p.m. PDT",2867,3056,2318,-549
BANC,"8/6/2016 7 p.m. PDT",2820,2999,2314,-506
BANC,"8/6/2016 8 p.m. PDT",2639,2817,2271,-368
BANC,"8/6/2016 9 p.m. PDT",2515,2680,2217,-298
BANC,"8/6/2016 10 p.m. PDT",2343,2500,1828,-515
BANC,"8/6/2016 11 p.m. PDT",2101,2233,1713,-388
BANC,"8/7/2016 12 a.m. PDT",1883,2004,1524,-359
BANC,"8/7/2016 1 a.m. PDT",1731,1790,1217,-514
BANC,"8/7/2016 2 a.m. PDT",1616,1661,1114,-502
BANC,"8/7/2016 3 a.m. PDT",1542,1584,1051,-491
BANC,"8/7/2016 4 a.m. PDT",1502,1532,1012,-490
BANC,"8/7/2016 5 a.m. PDT",1498,1509,1011,-487
BANC,"8/7/2016 6 a.m. PDT",1506,1521,1029,-477
BANC,"8/7/2016 7 a.m. PDT",1496,1524,1234,-262
BANC,"8/7/2016 8 a.m. PDT",1522,1549,1301,-221
BANC,"8/7/2016 9 a.m. PDT",1623,1659,1395,-228
BANC,"8/7/2016 10 a.m. PDT",1688,1757,1401,-287
BANC,"8/7/2016 11 a.m. PDT",1798,1870,1468,-330
BANC,"8/7/2016 12 p.m. PDT",1904,1999,1582,-322
BANC,"8/7/2016 1 p.m. PDT",2032,2139,1820,-212
BANC,"8/7/2016 2 p.m. PDT",2206,2307,2033,-173
BANC,"8/7/2016 3 p.m. PDT",2396,2488,2134,-262
BANC,"8/7/2016 4 p.m. PDT",2649,2646,2302,-347
BANC,"8/7/2016 5 p.m. PDT",2861,2831,2615,-246
BANC,"8/7/2016 6 p.m. PDT",3020,2909,2731,-289
BANC,"8/7/2016 7 p.m. PDT",3022,2863,2698,-324
BANC,"8/7/2016 8 p.m. PDT",2912,2700,2657,-255
BANC,"8/7/2016 9 p.m. PDT",2780,2591,2643,-137
BANC,"8/7/2016 10 p.m. PDT",2581,2379,2454,-127
BANC,"8/7/2016 11 p.m. PDT",2287,2120,1806,-481
BANC,"8/8/2016 12 a.m. PDT",1999,1895,1447,-552
BANC,"8/8/2016 1 a.m. PDT",1813,1746,1271,-542
BANC,"8/8/2016 2 a.m. PDT",1677,1624,1153,-524
BANC,"8/8/2016 3 a.m. PDT",1605,1559,1068,-537
BANC,"8/8/2016 4 a.m. PDT",1574,1532,1050,-524
BANC,"8/8/2016 5 a.m. PDT",1592,1549,1065,-527
BANC,"8/8/2016 6 a.m. PDT",1667,1633,1224,-443
BANC,"8/8/2016 7 a.m. PDT",1753,1720,1469,-284
BANC,"8/8/2016 8 a.m. PDT",1864,1838,1509,-355
BANC,"8/8/2016 9 a.m. PDT",1959,1968,1505,-454
BANC,"8/8/2016 10 a.m. PDT",2097,2087,1619,-478
BANC,"8/8/2016 11 a.m. PDT",2239,2230,1730,-509
BANC,"8/8/2016 12 p.m. PDT",2367,2368,1928,-439
BANC,"8/8/2016 1 p.m. PDT",2558,2516,2074,-484
BANC,"8/8/2016 2 p.m. PDT",2776,2712,2337,-439
BANC,"8/8/2016 3 p.m. PDT",3026,2915,2534,-492
BANC,"8/8/2016 4 p.m. PDT",3223,3111,2603,-620
BANC,"8/8/2016 5 p.m. PDT",3391,3271,2579,-812
BANC,"8/8/2016 6 p.m. PDT",3463,3334,2722,-741
BANC,"8/8/2016 7 p.m. PDT",3381,3241,2686,-695
BANC,"8/8/2016 8 p.m. PDT",3160,3047,2550,-610
BANC,"8/8/2016 9 p.m. PDT",2967,2870,2445,-522
BANC,"8/8/2016 10 p.m. PDT",2690,2637,2115,-575
BANC,"8/8/2016 11 p.m. PDT",2368,2320,1832,-536
BANC,"8/9/2016 12 a.m. PDT",2055,2038,1488,-567
BANC,"8/9/2016 1 a.m. PDT",1872,1863,1300,-572
BANC,"8/9/2016 2 a.m. PDT",1746,1724,1173,-573
BANC,"8/9/2016 3 a.m. PDT",1661,1648,1098,-563
BANC,"8/9/2016 4 a.m. PDT",1627,1596,1067,-560
BANC,"8/9/2016 5 a.m. PDT",1638,1612,1078,-560
BANC,"8/9/2016 6 a.m. PDT",1714,1688,1162,-552
BANC,"8/9/2016 7 a.m. PDT",1805,1789,1372,-433
BANC,"8/9/2016 8 a.m. PDT",1900,1887,1429,-471
BANC,"8/9/2016 9 a.m. PDT",1993,1995,1482,-511
BANC,"8/9/2016 10 a.m. PDT",2112,2132,1570,-542
BANC,"8/9/2016 11 a.m. PDT",2253,2292,1693,-560
BANC,"8/9/2016 12 p.m. PDT",2387,2489,1846,-541
BANC,"8/9/2016 1 p.m. PDT",2599,2689,1819,-780
BANC,"8/9/2016 2 p.m. PDT",2814,2962,1990,-824
BANC,"8/9/2016 3 p.m. PDT",3053,3237,2183,-870
BANC,"8/9/2016 4 p.m. PDT",3291,3467,2350,-941
BANC,"8/9/2016 5 p.m. PDT",3453,3648,2429,-1024
BANC,"8/9/2016 6 p.m. PDT",3549,3710,2593,-956
BANC,"8/9/2016 7 p.m. PDT",3468,3603,2606,-862
BANC,"8/9/2016 8 p.m. PDT",3285,3361,2567,-718
BANC,"8/9/2016 9 p.m. PDT",3117,3100,2582,-535
BANC,"8/9/2016 10 p.m. PDT",2869,2835,2152,-717
BANC,"8/9/2016 11 p.m. PDT",2518,2450,1900,-618
BANC,"8/10/2016 12 a.m. PDT",2194,2142,1621,-573
BANC,"8/10/2016 1 a.m. PDT",1965,1952,1319,-646
BANC,"8/10/2016 2 a.m. PDT",1825,1802,1194,-631
BANC,"8/10/2016 3 a.m. PDT",1723,1709,1125,-598
BANC,"8/10/2016 4 a.m. PDT",1674,1659,1108,-566
BANC,"8/10/2016 5 a.m. PDT",1684,1661,1116,-568
BANC,"8/10/2016 6 a.m. PDT",1763,1741,1209,-554
BANC,"8/10/2016 7 a.m. PDT",1862,1827,1441,-421
BANC,"8/10/2016 8 a.m. PDT",1957,1923,1540,-417
BANC,"8/10/2016 9 a.m. PDT",2056,2023,1532,-524
BANC,"8/10/2016 10 a.m. PDT",2175,2137,1634,-541
BANC,"8/10/2016 11 a.m. PDT",2311,2278,1764,-547
BANC,"8/10/2016 12 p.m. PDT",2479,2450,1935,-544
BANC,"8/10/2016 1 p.m. PDT",2677,2651,1891,-786
BANC,"8/10/2016 2 p.m. PDT",2919,2902,2227,-692
BANC,"8/10/2016 3 p.m. PDT",3161,3145,2409,-752
BANC,"8/10/2016 4 p.m. PDT",3370,3362,2635,-735
BANC,"8/10/2016 5 p.m. PDT",3530,3526,2826,-704
BANC,"8/10/2016 6 p.m. PDT",3570,3578,2871,-699
BANC,"8/10/2016 7 p.m. PDT",3489,3473,2826,-663
BANC,"8/10/2016 8 p.m. PDT",3315,3273,2543,-772
BANC,"8/10/2016 9 p.m. PDT",3130,3085,2601,-529
BANC,"8/10/2016 10 p.m. PDT",2862,2830,2205,-657
BANC,"8/10/2016 11 p.m. PDT",2484,2475,1876,-608
BANC,"8/11/2016 12 a.m. PDT",2161,2163,1554,-607
BANC,"8/11/2016 1 a.m. PDT",1947,1920,1319,-628
BANC,"8/11/2016 2 a.m. PDT",1791,1785,1173,-618
BANC,"8/11/2016 3 a.m. PDT",1700,1690,1118,-582
BANC,"8/11/2016 4 a.m. PDT",1663,1650,1105,-558
BANC,"8/11/2016 5 a.m. PDT",1659,1657,1096,-563
BANC,"8/11/2016 6 a.m. PDT",1737,1742,1247,-490
BANC,"8/11/2016 7 a.m. PDT",1843,1821,1505,-338
BANC,"8/11/2016 8 a.m. PDT",1934,1929,1559,-375
BANC,"8/11/2016 9 a.m. PDT",2012,2032,1543,-469
BANC,"8/11/2016 10 a.m. PDT",2141,2166,1627,-514
BANC,"8/11/2016 11 a.m. PDT",2291,2311,1750,-541
BANC,"8/11/2016 12 p.m. PDT",2468,2482,1933,-535
BANC,"8/11/2016 1 p.m. PDT",2697,2707,1899,-798
BANC,"8/11/2016 2 p.m. PDT",2953,2967,2174,-779
BANC,"8/11/2016 3 p.m. PDT",3247,3224,2497,-750
BANC,"8/11/2016 4 p.m. PDT",3469,3462,2669,-800
BANC,"8/11/2016 5 p.m. PDT",3620,3628,2705,-915
BANC,"8/11/2016 6 p.m. PDT",3647,3680,2827,-820
BANC,"8/11/2016 7 p.m. PDT",3533,3574,2763,-770
BANC,"8/11/2016 8 p.m. PDT",3312,3346,2648,-664
BANC,"8/11/2016 9 p.m. PDT",3138,3144,2575,-563
BANC,"8/11/2016 10 p.m. PDT",2870,2852,2318,-552
BANC,"8/11/2016 11 p.m. PDT",2496,2494,1910,-586
BANC,"8/12/2016 12 a.m. PDT",2169,2170,1590,-579
BANC,"8/12/2016 1 a.m. PDT",1949,2009,1363,-586
BANC,"8/12/2016 2 a.m. PDT",1803,1853,1260,-543
BANC,"8/12/2016 3 a.m. PDT",1712,1739,1190,-522
BANC,"8/12/2016 4 a.m. PDT",1660,1680,1143,-517
BANC,"8/12/2016 5 a.m. PDT",1675,1686,1167,-508
BANC,"8/12/2016 6 a.m. PDT",1744,1754,1247,-497
BANC,"8/12/2016 7 a.m. PDT",1842,1831,1529,-313
BANC,"8/12/2016 8 a.m. PDT",1928,1932,1642,-286
BANC,"8/12/2016 9 a.m. PDT",2029,2050,1616,-413
BANC,"8/12/2016 10 a.m. PDT",2168,2192,1740,-428
BANC,"8/12/2016 11 a.m. PDT",2317,2371,1861,-456
BANC,"8/12/2016 12 p.m. PDT",2520,2577,2029,-491
BANC,"8/12/2016 1 p.m. PDT",2755,2818,1992,-763
BANC,"8/12/2016 2 p.m. PDT",3042,3101,2298,-744
BANC,"8/12/2016 3 p.m. PDT",3335,3367,2564,-771
BANC,"8/12/2016 4 p.m. PDT",3564,3599,2736,-828
BANC,"8/12/2016 5 p.m. PDT",3733,3759,2758,-975
BANC,"8/12/2016 6 p.m. PDT",3787,3801,2782,-1005
BANC,"8/12/2016 7 p.m. PDT",3672,3704,2809,-863
BANC,"8/12/2016 8 p.m. PDT",3474,3496,2659,-815
BANC,"8/12/2016 9 p.m. PDT",3270,3260,2592,-678
BANC,"8/12/2016 10 p.m. PDT",2987,2974,2317,-670
BANC,"8/12/2016 11 p.m. PDT",2645,2611,2189,-456
BANC,"8/13/2016 12 a.m. PDT",2313,2277,1739,-574
BANC,"8/13/2016 1 a.m. PDT",2060,1995,1573,-487
BANC,"8/13/2016 2 a.m. PDT",1882,1842,1396,-486
BANC,"8/13/2016 3 a.m. PDT",1768,1727,1271,-497
BANC,"8/13/2016 4 a.m. PDT",1692,1657,1197,-495
BANC,"8/13/2016 5 a.m. PDT",1662,1627,1193,-469
BANC,"8/13/2016 6 a.m. PDT",1656,1636,1190,-466
BANC,"8/13/2016 7 a.m. PDT",1672,1622,1376,-296
BANC,"8/13/2016 8 a.m. PDT",1716,1685,1428,-288
BANC,"8/13/2016 9 a.m. PDT",1860,1823,1516,-344
BANC,"8/13/2016 10 a.m. PDT",2023,2010,1579,-444
BANC,"8/13/2016 11 a.m. PDT",2227,2214,1740,-487
BANC,"8/13/2016 12 p.m. PDT",2478,2456,2020,-458
BANC,"8/13/2016 1 p.m. PDT",2785,2718,2149,-636
BANC,"8/13/2016 2 p.m. PDT",3100,3003,2513,-587
BANC,"8/13/2016 3 p.m. PDT",3383,3276,2655,-728
BANC,"8/13/2016 4 p.m. PDT",3615,3498,2673,-942
BANC,"8/13/2016 5 p.m. PDT",3756,3671,2688,-1068
BANC,"8/13/2016 6 p.m. PDT",3791,3728,2685,-1106
BANC,"8/13/2016 7 p.m. PDT",3714,3679,2592,-1122
BANC,"8/13/2016 8 p.m. PDT",3494,3503,2491,-1003
BANC,"8/13/2016 9 p.m. PDT",3314,3299,2414,-900
BANC,"8/13/2016 10 p.m. PDT",3047,3035,2309,-738
BANC,"8/13/2016 11 p.m. PDT",2694,2685,2128,-566
BANC,"8/14/2016 12 a.m. PDT",2350,2362,1908,-442
BANC,"8/14/2016 1 a.m. PDT",2102,1985,1480,-622
BANC,"8/14/2016 2 a.m. PDT",1919,1826,1326,-593
BANC,"8/14/2016 3 a.m. PDT",1798,1728,1241,-557
BANC,"8/14/2016 4 a.m. PDT",1708,1657,1190,-518
BANC,"8/14/2016 5 a.m. PDT",1665,1624,1155,-510
BANC,"8/14/2016 6 a.m. PDT",1660,1628,1156,-504
BANC,"8/14/2016 7 a.m. PDT",1640,1607,1342,-298
BANC,"8/14/2016 8 a.m. PDT",1690,1651,1323,-367
BANC,"8/14/2016 9 a.m. PDT",1839,1785,1422,-417
BANC,"8/14/2016 10 a.m. PDT",2030,1946,1570,-460
BANC,"8/14/2016 11 a.m. PDT",2240,2141,1653,-587
BANC,"8/14/2016 12 p.m. PDT",2522,2369,1858,-664
BANC,"8/14/2016 1 p.m. PDT",2831,2628,2033,-798
BANC,"8/14/2016 2 p.m. PDT",3153,2908,2271,-882
BANC,"8/14/2016 3 p.m. PDT",3448,3184,2392,-1056
BANC,"8/14/2016 4 p.m. PDT",3684,3425,2759,-925
BANC,"8/14/2016 5 p.m. PDT",3826,3596,2824,-1002
BANC,"8/14/2016 6 p.m. PDT",3889,3671,3023,-866
BANC,"8/14/2016 7 p.m. PDT",3808,3610,2877,-931
BANC,"8/14/2016 8 p.m. PDT",3614,3405,2647,-967
BANC,"8/14/2016 9 p.m. PDT",3397,3238,2515,-882
BANC,"8/14/2016 10 p.m. PDT",3099,2963,2220,-879
BANC,"8/14/2016 11 p.m. PDT",2695,2605,2090,-605
BANC,"8/15/2016 12 a.m. PDT",2325,2256,1703,-622
BANC,"8/15/2016 1 a.m. PDT",2059,2013,1394,-665
BANC,"8/15/2016 2 a.m. PDT",1892,1854,1279,-613
BANC,"8/15/2016 3 a.m. PDT",1763,1750,1170,-593
BANC,"8/15/2016 4 a.m. PDT",1705,1694,1135,-570
BANC,"8/15/2016 5 a.m. PDT",1704,1702,1133,-571
BANC,"8/15/2016 6 a.m. PDT",1777,1773,1209,-568
BANC,"8/15/2016 7 a.m. PDT",1882,1859,1441,-441
BANC,"8/15/2016 8 a.m. PDT",1963,1974,1479,-484
BANC,"8/15/2016 9 a.m. PDT",2043,2104,1509,-534
BANC,"8/15/2016 10 a.m. PDT",2162,2259,1634,-528
BANC,"8/15/2016 11 a.m. PDT",2309,2437,1772,-537
BANC,"8/15/2016 12 p.m. PDT",2454,2665,1933,-521
BANC,"8/15/2016 1 p.m. PDT",2665,2927,2044,-621
BANC,"8/15/2016 2 p.m. PDT",2899,3229,2184,-715
BANC,"8/15/2016 3 p.m. PDT",3153,3529,2216,-937
BANC,"8/15/2016 4 p.m. PDT",3385,3781,2285,-1100
BANC,"8/15/2016 5 p.m. PDT",3568,3937,2372,-1196
BANC,"8/15/2016 6 p.m. PDT",3640,3980,2510,-1130
BANC,"8/15/2016 7 p.m. PDT",3552,3855,2495,-1057
BANC,"8/15/2016 8 p.m. PDT",3331,3620,2392,-939
BANC,"8/15/2016 9 p.m. PDT",3158,3399,2283,-875
BANC,"8/15/2016 10 p.m. PDT",2867,3070,2128,-739
BANC,"8/15/2016 11 p.m. PDT",2491,2702,1909,-582
BANC,"8/16/2016 12 a.m. PDT",2162,2345,1587,-575
BANC,"8/16/2016 1 a.m. PDT",1984,2111,1322,-662
BANC,"8/16/2016 2 a.m. PDT",1856,1938,1191,-665
BANC,"8/16/2016 3 a.m. PDT",1763,1830,1153,-610
BANC,"8/16/2016 4 a.m. PDT",1702,1753,1108,-594
BANC,"8/16/2016 5 a.m. PDT",1715,1762,1125,-590
BANC,"8/16/2016 6 a.m. PDT",1809,1835,1220,-589
BANC,"8/16/2016 7 a.m. PDT",1910,1925,1496,-414
BANC,"8/16/2016 8 a.m. PDT",1983,2031,1552,-431
BANC,"8/16/2016 9 a.m. PDT",2081,2164,1515,-566
BANC,"8/16/2016 10 a.m. PDT",2204,2315,1662,-542
BANC,"8/16/2016 11 a.m. PDT",2356,2499,1787,-569
BANC,"8/16/2016 12 p.m. PDT",2540,2713,1999,-541
BANC,"8/16/2016 1 p.m. PDT",2766,2948,2060,-706
BANC,"8/16/2016 2 p.m. PDT",3048,3257,2247,-801
BANC,"8/16/2016 3 p.m. PDT",3337,3533,2414,-923
BANC,"8/16/2016 4 p.m. PDT",3600,3787,2344,-1256
BANC,"8/16/2016 5 p.m. PDT",3781,3966,2459,-1322
BANC,"8/16/2016 6 p.m. PDT",3846,4029,2475,-1371
BANC,"8/16/2016 7 p.m. PDT",3739,3924,2442,-1297
BANC,"8/16/2016 8 p.m. PDT",3516,3709,2305,-1211
BANC,"8/16/2016 9 p.m. PDT",3338,3506,2363,-975
BANC,"8/16/2016 10 p.m. PDT",3036,3184,2172,-864
BANC,"8/16/2016 11 p.m. PDT",2659,2765,1926,-733
BANC,"8/17/2016 12 a.m. PDT",2327,2392,1634,-693
BANC,"8/17/2016 1 a.m. PDT",2089,2084,1460,-629
BANC,"8/17/2016 2 a.m. PDT",1923,1920,1343,-580
BANC,"8/17/2016 3 a.m. PDT",1826,1809,1251,-575
BANC,"8/17/2016 4 a.m. PDT",1770,1743,1197,-573
BANC,"8/17/2016 5 a.m. PDT",1776,1747,1206,-570
BANC,"8/17/2016 6 a.m. PDT",1855,1822,1284,-571
BANC,"8/17/2016 7 a.m. PDT",1939,1903,1539,-400
BANC,"8/17/2016 8 a.m. PDT",2049,2019,1639,-410
BANC,"8/17/2016 9 a.m. PDT",2149,2134,1643,-506
BANC,"8/17/2016 10 a.m. PDT",2286,2294,1696,-590
BANC,"8/17/2016 11 a.m. PDT",2454,2498,1852,-602
BANC,"8/17/2016 12 p.m. PDT",2664,2702,2070,-594
BANC,"8/17/2016 1 p.m. PDT",2899,2998,2132,-767
BANC,"8/17/2016 2 p.m. PDT",3206,3289,2434,-772
BANC,"8/17/2016 3 p.m. PDT",3501,3580,2501,-1000
BANC,"8/17/2016 4 p.m. PDT",3765,3852,2531,-1234
BANC,"8/17/2016 5 p.m. PDT",3926,4020,2603,-1323
BANC,"8/17/2016 6 p.m. PDT",3966,4076,2562,-1404
BANC,"8/17/2016 7 p.m. PDT",3832,3936,2478,-1354
BANC,"8/17/2016 8 p.m. PDT",3614,3678,2380,-1234
BANC,"8/17/2016 9 p.m. PDT",3420,3466,2317,-1103
BANC,"8/17/2016 10 p.m. PDT",3108,3163,2188,-920
BANC,"8/17/2016 11 p.m. PDT",2718,2772,2056,-662
BANC,"8/18/2016 12 a.m. PDT",2358,2425,1728,-630
BANC,"8/18/2016 1 a.m. PDT",2124,2058,1485,-639
BANC,"8/18/2016 2 a.m. PDT",1954,1900,1270,-684
BANC,"8/18/2016 3 a.m. PDT",1836,1789,1226,-610
BANC,"8/18/2016 4 a.m. PDT",1787,1733,1188,-599
BANC,"8/18/2016 5 a.m. PDT",1785,1743,1185,-600
BANC,"8/18/2016 6 a.m. PDT",1873,1812,1269,-604
BANC,"8/18/2016 7 a.m. PDT",1986,1905,1564,-422
BANC,"8/18/2016 8 a.m. PDT",2061,1999,1633,-428
BANC,"8/18/2016 9 a.m. PDT",2158,2108,1640,-518
BANC,"8/18/2016 10 a.m. PDT",2284,2261,1715,-569
BANC,"8/18/2016 11 a.m. PDT",2466,2434,1866,-600
BANC,"8/18/2016 12 p.m. PDT",2666,2646,2065,-601
BANC,"8/18/2016 1 p.m. PDT",2909,2896,2058,-851
BANC,"8/18/2016 2 p.m. PDT",3183,3165,2254,-929
BANC,"8/18/2016 3 p.m. PDT",3469,3453,2526,-943
BANC,"8/18/2016 4 p.m. PDT",3692,3701,2653,-1039
BANC,"8/18/2016 5 p.m. PDT",3834,3897,2679,-1155
BANC,"8/18/2016 6 p.m. PDT",3842,3940,2694,-1148
BANC,"8/18/2016 7 p.m. PDT",3684,3797,2581,-1103
BANC,"8/18/2016 8 p.m. PDT",3458,3549,2509,-949
BANC,"8/18/2016 9 p.m. PDT",3278,3363,2569,-709
BANC,"8/18/2016 10 p.m. PDT",3003,3017,2197,-806
BANC,"8/18/2016 11 p.m. PDT",2638,2637,2080,-558
BANC,"8/19/2016 12 a.m. PDT",2307,2285,1742,-565
BANC,"8/19/2016 1 a.m. PDT",2069,2021,1438,-631
BANC,"8/19/2016 2 a.m. PDT",1924,1875,1330,-594
BANC,"8/19/2016 3 a.m. PDT",1824,1770,1213,-611
BANC,"8/19/2016 4 a.m. PDT",1765,1716,1155,-610
BANC,"8/19/2016 5 a.m. PDT",1769,1724,1152,-617
BANC,"8/19/2016 6 a.m. PDT",1841,1797,1247,-594
BANC,"8/19/2016 7 a.m. PDT",1959,1889,1463,-496
BANC,"8/19/2016 8 a.m. PDT",2025,1988,1529,-496
BANC,"8/19/2016 9 a.m. PDT",2118,2084,1556,-562
BANC,"8/19/2016 10 a.m. PDT",2235,2224,1691,-544
BANC,"8/19/2016 11 a.m. PDT",2375,2376,1855,-520
BANC,"8/19/2016 12 p.m. PDT",2523,2549,2062,-461
BANC,"8/19/2016 1 p.m. PDT",2737,2752,2025,-712
BANC,"8/19/2016 2 p.m. PDT",2950,2999,2317,-633
BANC,"8/19/2016 3 p.m. PDT",3176,3250,2620,-556
BANC,"8/19/2016 4 p.m. PDT",3406,3477,2788,-618
BANC,"8/19/2016 5 p.m. PDT",3545,3635,2791,-754
BANC,"8/19/2016 6 p.m. PDT",3562,3658,2723,-839
BANC,"8/19/2016 7 p.m. PDT",3363,3536,2594,-769
BANC,"8/19/2016 8 p.m. PDT",3130,3298,2377,-753
BANC,"8/19/2016 9 p.m. PDT",2962,3124,2123,-839
BANC,"8/19/2016 10 p.m. PDT",2720,2870,1849,-871
BANC,"8/19/2016 11 p.m. PDT",2432,2522,1902,-530
BANC,"8/20/2016 12 a.m. PDT",2154,2217,1611,-543
BANC,"8/20/2016 1 a.m. PDT",1964,1978,1482,-482
BANC,"8/20/2016 2 a.m. PDT",1807,1830,1316,-491
BANC,"8/20/2016 3 a.m. PDT",1732,1725,1257,-475
BANC,"8/20/2016 4 a.m. PDT",1686,1667,1159,-527
BANC,"8/20/2016 5 a.m. PDT",1661,1644,1060,-601
BANC,"8/20/2016 6 a.m. PDT",1673,1659,1110,-563
BANC,"8/20/2016 7 a.m. PDT",1676,1660,1331,-345
BANC,"8/20/2016 8 a.m. PDT",1726,1694,1344,-382
BANC,"8/20/2016 9 a.m. PDT",1834,1822,1390,-444
BANC,"8/20/2016 10 a.m. PDT",1974,1973,1543,-431
BANC,"8/20/2016 11 a.m. PDT",2112,2123,1639,-473
BANC,"8/20/2016 12 p.m. PDT",2285,2301,1850,-435
BANC,"8/20/2016 1 p.m. PDT",2489,2506,1858,-631
BANC,"8/20/2016 2 p.m. PDT",2726,2738,2176,-550
BANC,"8/20/2016 3 p.m. PDT",2980,2964,2517,-463
BANC,"8/20/2016 4 p.m. PDT",3188,3185,2584,-604
BANC,"8/20/2016 5 p.m. PDT",3361,3326,2699,-662
BANC,"8/20/2016 6 p.m. PDT",3393,3357,2752,-641
BANC,"8/20/2016 7 p.m. PDT",3252,3259,2566,-686
BANC,"8/20/2016 8 p.m. PDT",3007,3056,2335,-672
BANC,"8/20/2016 9 p.m. PDT",2813,2921,2212,-601
BANC,"8/20/2016 10 p.m. PDT",2566,2681,1853,-713
BANC,"8/20/2016 11 p.m. PDT",2303,2376,1631,-672
BANC,"8/21/2016 12 a.m. PDT",2049,2114,1412,-637
BANC,"8/21/2016 1 a.m. PDT",1879,1883,1158,-721
BANC,"8/21/2016 2 a.m. PDT",1744,1747,1090,-654
BANC,"8/21/2016 3 a.m. PDT",1668,1664,1084,-584
BANC,"8/21/2016 4 a.m. PDT",1608,1612,996,-612
BANC,"8/21/2016 5 a.m. PDT",1586,1580,980,-606
BANC,"8/21/2016 6 a.m. PDT",1601,1593,1007,-594
BANC,"8/21/2016 7 a.m. PDT",1598,1589,1240,-358
BANC,"8/21/2016 8 a.m. PDT",1621,1613,1279,-342
BANC,"8/21/2016 9 a.m. PDT",1703,1713,1338,-365
BANC,"8/21/2016 10 a.m. PDT",1835,1853,1380,-455
BANC,"8/21/2016 11 a.m. PDT",1948,1989,1500,-448
BANC,"8/21/2016 12 p.m. PDT",2082,2146,1655,-427
BANC,"8/21/2016 1 p.m. PDT",2244,2327,1807,-437
BANC,"8/21/2016 2 p.m. PDT",2461,2524,2033,-428
BANC,"8/21/2016 3 p.m. PDT",2701,2738,2316,-385
BANC,"8/21/2016 4 p.m. PDT",2923,2945,2393,-530
BANC,"8/21/2016 5 p.m. PDT",3091,3101,2432,-659
BANC,"8/21/2016 6 p.m. PDT",3136,3155,2420,-716
BANC,"8/21/2016 7 p.m. PDT",3027,3106,2380,-647
BANC,"8/21/2016 8 p.m. PDT",2818,2948,2203,-615
BANC,"8/21/2016 9 p.m. PDT",2708,2829,2266,-442
BANC,"8/21/2016 10 p.m. PDT",2489,2613,2066,-423
BANC,"8/21/2016 11 p.m. PDT",2195,2314,1641,-554
BANC,"8/22/2016 12 a.m. PDT",1958,2047,1234,-724
BANC,"8/22/2016 1 a.m. PDT",1788,1864,1002,-786
BANC,"8/22/2016 2 a.m. PDT",1678,1744,904,-774
BANC,"8/22/2016 3 a.m. PDT",1627,1667,912,-715
BANC,"8/22/2016 4 a.m. PDT",1598,1634,905,-693
BANC,"8/22/2016 5 a.m. PDT",1631,1647,931,-700
BANC,"8/22/2016 6 a.m. PDT",1727,1723,1076,-651
BANC,"8/22/2016 7 a.m. PDT",1872,1817,1485,-387
BANC,"8/22/2016 8 a.m. PDT",1937,1913,1547,-390
BANC,"8/22/2016 9 a.m. PDT",1989,1999,1478,-511
BANC,"8/22/2016 10 a.m. PDT",2090,2126,1580,-510
BANC,"8/22/2016 11 a.m. PDT",2184,2252,1714,-470
BANC,"8/22/2016 12 p.m. PDT",2283,2393,1774,-509
BANC,"8/22/2016 1 p.m. PDT",2408,2568,1723,-685
BANC,"8/22/2016 2 p.m. PDT",2577,2780,1866,-711
BANC,"8/22/2016 3 p.m. PDT",2794,2989,2191,-603
BANC,"8/22/2016 4 p.m. PDT",2997,3191,2438,-559
BANC,"8/22/2016 5 p.m. PDT",3174,3343,2551,-623
BANC,"8/22/2016 6 p.m. PDT",3215,3399,2530,-685
BANC,"8/22/2016 7 p.m. PDT",3079,3319,2476,-603
BANC,"8/22/2016 8 p.m. PDT",2869,3124,2363,-506
BANC,"8/22/2016 9 p.m. PDT",2746,2926,2191,-555
BANC,"8/22/2016 10 p.m. PDT",2509,2705,1892,-617
BANC,"8/22/2016 11 p.m. PDT",2224,2404,1585,-639
BANC,"8/23/2016 12 a.m. PDT",1976,2108,1294,-682
BANC,"8/23/2016 1 a.m. PDT",1807,1883,1287,-520
BANC,"8/23/2016 2 a.m. PDT",1708,1755,1208,-500
BANC,"8/23/2016 3 a.m. PDT",1650,1683,1171,-479
BANC,"8/23/2016 4 a.m. PDT",1614,1647,1112,-502
BANC,"8/23/2016 5 a.m. PDT",1635,1659,1194,-441
BANC,"8/23/2016 6 a.m. PDT",1728,1735,1306,-422
BANC,"8/23/2016 7 a.m. PDT",1867,1824,1542,-325
BANC,"8/23/2016 8 a.m. PDT",1917,1913,1643,-274
BANC,"8/23/2016 9 a.m. PDT",1979,1999,1542,-437
BANC,"8/23/2016 10 a.m. PDT",2071,2109,1666,-405
BANC,"8/23/2016 11 a.m. PDT",2161,2231,1770,-391
BANC,"8/23/2016 12 p.m. PDT",2256,2363,1871,-385
BANC,"8/23/2016 1 p.m. PDT",2394,2529,2002,-392
BANC,"8/23/2016 2 p.m. PDT",2560,2734,2153,-407
BANC,"8/23/2016 3 p.m. PDT",2739,2950,2243,-496
BANC,"8/23/2016 4 p.m. PDT",2933,3142,2346,-587
BANC,"8/23/2016 5 p.m. PDT",3100,3309,2422,-678
BANC,"8/23/2016 6 p.m. PDT",3147,3367,2407,-740
BANC,"8/23/2016 7 p.m. PDT",3029,3286,2336,-693
BANC,"8/23/2016 8 p.m. PDT",2843,3104,2206,-637
BANC,"8/23/2016 9 p.m. PDT",2741,2914,2198,-543
BANC,"8/23/2016 10 p.m. PDT",2508,2692,2014,-494
BANC,"8/23/2016 11 p.m. PDT",2220,2399,1802,-418
BANC,"8/24/2016 12 a.m. PDT",1971,2104,1531,-440
BANC,"8/24/2016 1 a.m. PDT",1800,1845,1257,-543
BANC,"8/24/2016 2 a.m. PDT",1694,1729,1198,-496
BANC,"8/24/2016 3 a.m. PDT",1639,1667,1097,-542
BANC,"8/24/2016 4 a.m. PDT",1600,1620,1093,-507
BANC,"8/24/2016 5 a.m. PDT",1627,1645,1095,-532
BANC,"8/24/2016 6 a.m. PDT",1713,1736,1197,-516
BANC,"8/24/2016 7 a.m. PDT",1847,1849,1550,-297
BANC,"8/24/2016 8 a.m. PDT",1911,1935,1692,-219
BANC,"8/24/2016 9 a.m. PDT",1979,2029,1781,-198
BANC,"8/24/2016 10 a.m. PDT",2042,2154,1740,-302
BANC,"8/24/2016 11 a.m. PDT",2157,2273,1832,-325
BANC,"8/24/2016 12 p.m. PDT",2252,2427,1951,-301
BANC,"8/24/2016 1 p.m. PDT",2383,2582,1835,-548
BANC,"8/24/2016 2 p.m. PDT",2555,2768,2087,-468
BANC,"8/24/2016 3 p.m. PDT",2751,2989,2234,-517
BANC,"8/24/2016 4 p.m. PDT",2974,3158,2410,-564
BANC,"8/24/2016 5 p.m. PDT",3137,3315,2470,-667
BANC,"8/24/2016 6 p.m. PDT",3223,3379,2521,-702
BANC,"8/24/2016 7 p.m. PDT",3148,3269,2625,-523
BANC,"8/24/2016 8 p.m. PDT",2971,3061,2330,-641
BANC,"8/24/2016 9 p.m. PDT",2848,2926,2275,-573
BANC,"8/24/2016 10 p.m. PDT",2600,2662,2038,-562
BANC,"8/24/2016 11 p.m. PDT",2277,2360,1741,-536
BANC,"8/25/2016 12 a.m. PDT",2011,2073,1422,-589
BANC,"8/25/2016 1 a.m. PDT",1812,1826,1287,-525
BANC,"8/25/2016 2 a.m. PDT",1713,1718,1189,-524
BANC,"8/25/2016 3 a.m. PDT",1637,1641,1116,-521
BANC,"8/25/2016 4 a.m. PDT",1605,1613,1104,-501
BANC,"8/25/2016 5 a.m. PDT",1626,1640,1113,-513
BANC,"8/25/2016 6 a.m. PDT",1697,1741,1187,-510
BANC,"8/25/2016 7 a.m. PDT",1839,1857,1426,-413
BANC,"8/25/2016 8 a.m. PDT",1905,1939,1507,-398
BANC,"8/25/2016 9 a.m. PDT",1966,2027,1538,-428
BANC,"8/25/2016 10 a.m. PDT",2040,2118,1581,-459
BANC,"8/25/2016 11 a.m. PDT",2146,2248,1704,-442
BANC,"8/25/2016 12 p.m. PDT",2227,2373,1679,-548
BANC,"8/25/2016 1 p.m. PDT",2364,2504,1642,-722
BANC,"8/25/2016 2 p.m. PDT",2548,2696,1903,-645
BANC,"8/25/2016 3 p.m. PDT",2765,2904,2299,-466
BANC,"8/25/2016 4 p.m. PDT",2975,3099,2486,-489
BANC,"8/25/2016 5 p.m. PDT",3147,3272,2599,-548
BANC,"8/25/2016 6 p.m. PDT",3211,3329,2623,-588
BANC,"8/25/2016 7 p.m. PDT",3112,3244,2682,-430
BANC,"8/25/2016 8 p.m. PDT",2923,3080,2505,-418
BANC,"8/25/2016 9 p.m. PDT",2803,2941,2425,-378
BANC,"8/25/2016 10 p.m. PDT",2545,2677,2050,-495
BANC,"8/25/2016 11 p.m. PDT",2213,2375,1693,-520
BANC,"8/26/2016 12 a.m. PDT",1959,2082,1454,-505
BANC,"8/26/2016 1 a.m. PDT",1773,1850,1235,-538
BANC,"8/26/2016 2 a.m. PDT",1680,1737,1148,-532
BANC,"8/26/2016 3 a.m. PDT",1620,1658,1075,-545
BANC,"8/26/2016 4 a.m. PDT",1591,1624,1054,-537
BANC,"8/26/2016 5 a.m. PDT",1608,1638,1120,-488
BANC,"8/26/2016 6 a.m. PDT",1685,1724,1205,-480
BANC,"8/26/2016 7 a.m. PDT",1819,1853,1500,-319
BANC,"8/26/2016 8 a.m. PDT",1877,1920,1573,-304
BANC,"8/26/2016 9 a.m. PDT",1941,2001,1523,-418
BANC,"8/26/2016 10 a.m. PDT",2034,2082,1586,-448
BANC,"8/26/2016 11 a.m. PDT",2116,2200,1673,-443
BANC,"8/26/2016 12 p.m. PDT",2207,2313,1785,-422
BANC,"8/26/2016 1 p.m. PDT",2320,2454,1807,-513
BANC,"8/26/2016 2 p.m. PDT",2435,2624,2041,-394
BANC,"8/26/2016 3 p.m. PDT",2584,2817,2149,-435
BANC,"8/26/2016 4 p.m. PDT",2720,3016,2118,-602
BANC,"8/26/2016 5 p.m. PDT",2809,3190,2156,-653
BANC,"8/26/2016 6 p.m. PDT",2831,3243,2231,-600
BANC,"8/26/2016 7 p.m. PDT",2705,3145,2371,-334
BANC,"8/26/2016 8 p.m. PDT",2536,2957,2186,-350
BANC,"8/26/2016 9 p.m. PDT",2476,2828,2042,-434
BANC,"8/26/2016 10 p.m. PDT",2301,2600,1776,-525
BANC,"8/26/2016 11 p.m. PDT",2093,2297,1625,-468
BANC,"8/27/2016 12 a.m. PDT",1895,2028,1408,-487
BANC,"8/27/2016 1 a.m. PDT",1736,1822,1235,-501
BANC,"8/27/2016 2 a.m. PDT",1647,1711,1138,-509
BANC,"8/27/2016 3 a.m. PDT",1593,1621,1106,-487
BANC,"8/27/2016 4 a.m. PDT",1561,1581,1085,-476
BANC,"8/27/2016 5 a.m. PDT",1557,1567,1074,-483
BANC,"8/27/2016 6 a.m. PDT",1589,1588,1109,-480
BANC,"8/27/2016 7 a.m. PDT",1626,1596,1254,-372
BANC,"8/27/2016 8 a.m. PDT",1643,1634,1283,-360
BANC,"8/27/2016 9 a.m. PDT",1753,1743,1353,-400
BANC,"8/27/2016 10 a.m. PDT",1827,1862,1422,-405
BANC,"8/27/2016 11 a.m. PDT",1910,1979,1509,-401
BANC,"8/27/2016 12 p.m. PDT",1984,2101,1600,-384
BANC,"8/27/2016 1 p.m. PDT",2072,2243,1557,-515
BANC,"8/27/2016 2 p.m. PDT",2182,2416,1737,-445
BANC,"8/27/2016 3 p.m. PDT",2319,2622,1918,-401
BANC,"8/27/2016 4 p.m. PDT",2464,2815,2032,-432
BANC,"8/27/2016 5 p.m. PDT",2583,2983,2077,-506
BANC,"8/27/2016 6 p.m. PDT",2625,3043,2146,-479
BANC,"8/27/2016 7 p.m. PDT",2560,2996,2078,-482
BANC,"8/27/2016 8 p.m. PDT",2435,2816,2033,-402
BANC,"8/27/2016 9 p.m. PDT",2382,2683,2005,-377
BANC,"8/27/2016 10 p.m. PDT",2244,2482,1934,-310
BANC,"8/27/2016 11 p.m. PDT",2042,2222,1543,-499
BANC,"8/28/2016 12 a.m. PDT",1847,1995,1290,-557
BANC,"8/28/2016 1 a.m. PDT",1705,1736,1275,-430
BANC,"8/28/2016 2 a.m. PDT",1614,1648,1223,-391
BANC,"8/28/2016 3 a.m. PDT",1548,1576,1157,-391
BANC,"8/28/2016 4 a.m. PDT",1524,1546,1142,-382
BANC,"8/28/2016 5 a.m. PDT",1510,1531,1129,-381
BANC,"8/28/2016 6 a.m. PDT",1518,1545,1150,-368
BANC,"8/28/2016 7 a.m. PDT",1534,1552,1365,-169
BANC,"8/28/2016 8 a.m. PDT",1549,1575,1392,-157
BANC,"8/28/2016 9 a.m. PDT",1642,1677,1443,-199
BANC,"8/28/2016 10 a.m. PDT",1724,1802,1476,-248
BANC,"8/28/2016 11 a.m. PDT",1815,1921,1613,-202
BANC,"8/28/2016 12 p.m. PDT",1895,2027,1680,-215
BANC,"8/28/2016 1 p.m. PDT",2015,2176,1673,-342
BANC,"8/28/2016 2 p.m. PDT",2134,2363,1831,-303
BANC,"8/28/2016 3 p.m. PDT",2333,2604,2072,-261
BANC,"8/28/2016 4 p.m. PDT",2537,2806,2163,-374
BANC,"8/28/2016 5 p.m. PDT",2734,2982,2198,-536
BANC,"8/28/2016 6 p.m. PDT",2863,3030,2430,-433
BANC,"8/28/2016 7 p.m. PDT",2845,2946,2440,-405
BANC,"8/28/2016 8 p.m. PDT",2732,2759,2385,-347
BANC,"8/28/2016 9 p.m. PDT",2650,2693,2352,-298
BANC,"8/28/2016 10 p.m. PDT",2410,2433,2159,-251
BANC,"8/28/2016 11 p.m. PDT",2136,2176,1816,-320
BANC,"8/29/2016 12 a.m. PDT",1891,1927,1488,-403
BANC,"8/29/2016 1 a.m. PDT",1724,1728,1279,-445
BANC,"8/29/2016 2 a.m. PDT",1625,1629,1186,-439
BANC,"8/29/2016 3 a.m. PDT",1565,1558,1136,-429
BANC,"8/29/2016 4 a.m. PDT",1544,1541,1118,-426
BANC,"8/29/2016 5 a.m. PDT",1573,1571,1155,-418
BANC,"8/29/2016 6 a.m. PDT",1665,1671,1237,-428
BANC,"8/29/2016 7 a.m. PDT",1815,1817,1403,-412
BANC,"8/29/2016 8 a.m. PDT",1877,1898,1424,-453
BANC,"8/29/2016 9 a.m. PDT",1948,1960,1508,-440
BANC,"8/29/2016 10 a.m. PDT",2033,2045,1559,-474
BANC,"8/29/2016 11 a.m. PDT",2110,2149,1653,-457
BANC,"8/29/2016 12 p.m. PDT",2199,2248,1758,-441
BANC,"8/29/2016 1 p.m. PDT",2319,2365,1856,-463
BANC,"8/29/2016 2 p.m. PDT",2475,2542,2102,-373
BANC,"8/29/2016 3 p.m. PDT",2626,2738,2184,-442
BANC,"8/29/2016 4 p.m. PDT",2779,2949,2258,-521
BANC,"8/29/2016 5 p.m. PDT",2898,3121,2296,-602
BANC,"8/29/2016 6 p.m. PDT",2954,3178,2501,-453
BANC,"8/29/2016 7 p.m. PDT",2843,3073,2387,-456
BANC,"8/29/2016 8 p.m. PDT",2698,2886,2259,-439
BANC,"8/29/2016 9 p.m. PDT",2599,2766,2219,-380
BANC,"8/29/2016 10 p.m. PDT",2376,2521,2017,-359
BANC,"8/29/2016 11 p.m. PDT",2119,2220,1734,-385
BANC,"8/30/2016 12 a.m. PDT",1883,1966,1456,-427
BANC,"8/30/2016 1 a.m. PDT",1752,1768,1349,-403
BANC,"8/30/2016 2 a.m. PDT",1651,1669,1245,-406
BANC,"8/30/2016 3 a.m. PDT",1621,1612,1198,-423
BANC,"8/30/2016 4 a.m. PDT",1590,1583,1161,-429
BANC,"8/30/2016 5 a.m. PDT",1628,1604,1211,-417
BANC,"8/30/2016 6 a.m. PDT",1718,1692,1319,-399
BANC,"8/30/2016 7 a.m. PDT",1889,1831,1589,-300
BANC,"8/30/2016 8 a.m. PDT",1954,1909,1665,-289
BANC,"8/30/2016 9 a.m. PDT",2012,1974,1644,-368
BANC,"8/30/2016 10 a.m. PDT",2122,2053,1710,-412
BANC,"8/30/2016 11 a.m. PDT",2223,2144,1832,-391
BANC,"8/30/2016 12 p.m. PDT",2330,2242,1992,-338
BANC,"8/30/2016 1 p.m. PDT",2482,2357,2002,-480
BANC,"8/30/2016 2 p.m. PDT",2679,2521,2245,-434
BANC,"8/30/2016 3 p.m. PDT",2845,2710,2341,-504
BANC,"8/30/2016 4 p.m. PDT",3060,2918,2451,-609
BANC,"8/30/2016 5 p.m. PDT",3240,3087,2507,-733
BANC,"8/30/2016 6 p.m. PDT",3308,3134,2571,-737
BANC,"8/30/2016 7 p.m. PDT",3246,3019,2634,-612
BANC,"8/30/2016 8 p.m. PDT",3051,2844,2528,-523
BANC,"8/30/2016 9 p.m. PDT",2912,2734,2420,-492
BANC,"8/30/2016 10 p.m. PDT",2663,2502,2068,-595
BANC,"8/30/2016 11 p.m. PDT",2342,2209,1976,-366
BANC,"8/31/2016 12 a.m. PDT",2091,1962,1648,-443
BANC,"8/31/2016 1 a.m. PDT",1905,1786,1471,-434
BANC,"8/31/2016 2 a.m. PDT",1805,1693,1395,-410
BANC,"8/31/2016 3 a.m. PDT",1737,1640,1322,-415
BANC,"8/31/2016 4 a.m. PDT",1694,1611,1280,-414
BANC,"8/31/2016 5 a.m. PDT",1712,1631,1288,-424
BANC,"8/31/2016 6 a.m. PDT",1800,1723,1367,-433
BANC,"8/31/2016 7 a.m. PDT",1946,1844,1541,-405
BANC,"8/31/2016 8 a.m. PDT",2002,1912,1612,-390
BANC,"8/31/2016 9 a.m. PDT",2062,1974,1648,-414
BANC,"8/31/2016 10 a.m. PDT",2157,2045,1759,-398
BANC,"8/31/2016 11 a.m. PDT",2263,2141,1842,-421
BANC,"8/31/2016 12 p.m. PDT",2395,2228,2000,-395
BANC,"8/31/2016 1 p.m. PDT",2544,2347,1959,-585
BANC,"8/31/2016 2 p.m. PDT",2729,2486,2224,-505
BANC,"8/31/2016 3 p.m. PDT",2928,2657,2413,-515
BANC,"8/31/2016 4 p.m. PDT",3095,2834,2490,-605
BANC,"8/31/2016 5 p.m. PDT",3224,2976,2554,-670
BANC,"8/31/2016 6 p.m. PDT",3244,3049,2657,-587
BANC,"8/31/2016 7 p.m. PDT",3107,2955,2613,-494
BANC,"8/31/2016 8 p.m. PDT",2900,2793,2526,-374
BANC,"8/31/2016 9 p.m. PDT",2774,2697,2346,-428
BANC,"8/31/2016 10 p.m. PDT",2551,2474,1931,-620
BANC,"8/31/2016 11 p.m. PDT",2255,2196,1722,-533
BANC,"9/1/2016 12 a.m. PDT",2010,1952,1505,-505
