"BA Code","Timestamp (Hour Ending)","Demand (MWh)","Demand Forecast (MWh)","Net Generation (MWh)","Total Interchange (MWh)"
BANC,"4/1/2016 12 a.m. PDT",1591,1610,1212,-379
BANC,"4/1/2016 1 a.m. PDT",1446,1476,927,-519
BANC,"4/1/2016 2 a.m. PDT",1393,1413,918,-475
BANC,"4/1/2016 3 a.m. PDT",1354,1378,892,-462
BANC,"4/1/2016 4 a.m. PDT",1339,1367,880,-459
BANC,"4/1/2016 5 a.m. PDT",1386,1394,920,-466
BANC,"4/1/2016 6 a.m. PDT",1506,1507,1045,-461
BANC,"4/1/2016 7 a.m. PDT",1672,1693,1245,-427
BANC,"4/1/2016 8 a.m. PDT",1753,1790,1519,-234
BANC,"4/1/2016 9 a.m. PDT",1750,1795,1204,-546
BANC,"4/1/2016 10 a.m. PDT",1749,1776,1149,-600
BANC,"4/1/2016 11 a.m. PDT",1752,1771,1196,-556
BANC,"4/1/2016 12 p.m. PDT",1770,1780,1230,-540
BANC,"4/1/2016 1 p.m. PDT",1780,1785,1253,-527
BANC,"4/1/2016 2 p.m. PDT",1795,1786,1264,-531
BANC,"4/1/2016 3 p.m. PDT",1797,1792,1245,-552
BANC,"4/1/2016 4 p.m. PDT",1808,1796,1260,-548
BANC,"4/1/2016 5 p.m. PDT",1827,1815,1434,-393
BANC,"4/1/2016 6 p.m. PDT",1832,1820,1471,-361
BANC,"4/1/2016 7 p.m. PDT",1813,1828,1395,-418
BANC,"4/1/2016 8 p.m. PDT",1878,1913,1549,-329
BANC,"4/1/2016 9 p.m. PDT",1963,1948,1596,-367
BANC,"4/1/2016 10 p.m. PDT",1859,1860,1346,-513
BANC,"4/1/2016 11 p.m. PDT",1735,1717,1126,-609
BANC,"4/2/2016 12 a.m. PDT",1598,1584,961,-637
BANC,"4/2/2016 1 a.m. PDT",1451,1467,891,-560
BANC,"4/2/2016 2 a.m. PDT",1390,1393,879,-511
BANC,"4/2/2016 3 a.m. PDT",1350,1350,802,-548
BANC,"4/2/2016 4 a.m. PDT",1333,1322,797,-536
BANC,"4/2/2016 5 a.m. PDT",1333,1325,816,-517
BANC,"4/2/2016 6 a.m. PDT",1386,1362,860,-526
BANC,"4/2/2016 7 a.m. PDT",1445,1436,1042,-403
BANC,"4/2/2016 8 a.m. PDT",1477,1482,1143,-334
BANC,"4/2/2016 9 a.m. PDT",1548,1542,1132,-416
BANC,"4/2/2016 10 a.m. PDT",1581,1575,1052,-529
BANC,"4/2/2016 11 a.m. PDT",1615,1615,1095,-520
BANC,"4/2/2016 12 p.m. PDT",1626,1617,1140,-486
BANC,"4/2/2016 1 p.m. PDT",1634,1625,1211,-423
BANC,"4/2/2016 2 p.m. PDT",1624,1611,1184,-440
BANC,"4/2/2016 3 p.m. PDT",1629,1625,1183,-446
BANC,"4/2/2016 4 p.m. PDT",1644,1629,1153,-491
BANC,"4/2/2016 5 p.m. PDT",1689,1655,1209,-480
BANC,"4/2/2016 6 p.m. PDT",1714,1672,1303,-411
BANC,"4/2/2016 7 p.m. PDT",1746,1686,1297,-449
BANC,"4/2/2016 8 p.m. PDT",1796,1807,1470,-326
BANC,"4/2/2016 9 p.m. PDT",1846,1861,1586,-260
BANC,"4/2/2016 10 p.m. PDT",1794,1783,1479,-315
BANC,"4/2/2016 11 p.m. PDT",1684,1663,1142,-542
BANC,"4/3/2016 12 a.m. PDT",1532,1546,1126,-406
BANC,"4/3/2016 1 a.m. PDT",1449,1430,1084,-365
BANC,"4/3/2016 2 a.m. PDT",1365,1354,1084,-281
BANC,"4/3/2016 3 a.m. PDT",1320,1323,1051,-269
BANC,"4/3/2016 4 a.m. PDT",1309,1299,988,-321
BANC,"4/3/2016 5 a.m. PDT",1288,1304,930,-358
BANC,"4/3/2016 6 a.m. PDT",1321,1335,1022,-299
BANC,"4/3/2016 7 a.m. PDT",1348,1378,1102,-246
BANC,"4/3/2016 8 a.m. PDT",1405,1427,1201,-204
BANC,"4/3/2016 9 a.m. PDT",1461,1473,1145,-316
BANC,"4/3/2016 10 a.m. PDT",1515,1530,1144,-371
BANC,"4/3/2016 11 a.m. PDT",1550,1575,1195,-355
BANC,"4/3/2016 12 p.m. PDT",1598,1585,1181,-417
BANC,"4/3/2016 1 p.m. PDT",1614,1605,1194,-420
BANC,"4/3/2016 2 p.m. PDT",1640,1613,1212,-428
BANC,"4/3/2016 3 p.m. PDT",1656,1615,1199,-457
BANC,"4/3/2016 4 p.m. PDT",1690,1637,1259,-431
BANC,"4/3/2016 5 p.m. PDT",1726,1674,1262,-464
BANC,"4/3/2016 6 p.m. PDT",1761,1725,1270,-491
BANC,"4/3/2016 7 p.m. PDT",1780,1759,1318,-462
BANC,"4/3/2016 8 p.m. PDT",1852,1841,1452,-400
BANC,"4/3/2016 9 p.m. PDT",1897,1954,1578,-319
BANC,"4/3/2016 10 p.m. PDT",1818,1858,1572,-246
BANC,"4/3/2016 11 p.m. PDT",1667,1708,1279,-388
BANC,"4/4/2016 12 a.m. PDT",1517,1550,1145,-372
BANC,"4/4/2016 1 a.m. PDT",1429,1435,902,-527
BANC,"4/4/2016 2 a.m. PDT",1360,1360,793,-567
BANC,"4/4/2016 3 a.m. PDT",1349,1338,764,-585
BANC,"4/4/2016 4 a.m. PDT",1347,1329,748,-599
BANC,"4/4/2016 5 a.m. PDT",1368,1363,781,-587
BANC,"4/4/2016 6 a.m. PDT",1487,1473,916,-571
BANC,"4/4/2016 7 a.m. PDT",1668,1643,1153,-515
BANC,"4/4/2016 8 a.m. PDT",1742,1733,1208,-534
BANC,"4/4/2016 9 a.m. PDT",1770,1746,1253,-517
BANC,"4/4/2016 10 a.m. PDT",1786,1773,1182,-604
BANC,"4/4/2016 11 a.m. PDT",1821,1797,1185,-636
BANC,"4/4/2016 12 p.m. PDT",1838,1820,1247,-591
BANC,"4/4/2016 1 p.m. PDT",1861,1841,1309,-552
BANC,"4/4/2016 2 p.m. PDT",1896,1854,1291,-605
BANC,"4/4/2016 3 p.m. PDT",1897,1876,1195,-702
BANC,"4/4/2016 4 p.m. PDT",1903,1880,1176,-727
BANC,"4/4/2016 5 p.m. PDT",1931,1907,1213,-718
BANC,"4/4/2016 6 p.m. PDT",1941,1908,1274,-667
BANC,"4/4/2016 7 p.m. PDT",1953,1889,1341,-612
BANC,"4/4/2016 8 p.m. PDT",1988,1944,1595,-393
BANC,"4/4/2016 9 p.m. PDT",2072,2021,1622,-450
BANC,"4/4/2016 10 p.m. PDT",1944,1914,1328,-616
BANC,"4/4/2016 11 p.m. PDT",1765,1751,1177,-588
BANC,"4/5/2016 12 a.m. PDT",1587,1594,933,-654
BANC,"4/5/2016 1 a.m. PDT",1468,1487,869,-599
BANC,"4/5/2016 2 a.m. PDT",1397,1412,745,-652
BANC,"4/5/2016 3 a.m. PDT",1377,1377,788,-589
BANC,"4/5/2016 4 a.m. PDT",1357,1342,756,-601
BANC,"4/5/2016 5 a.m. PDT",1404,1373,749,-655
BANC,"4/5/2016 6 a.m. PDT",1507,1491,947,-560
BANC,"4/5/2016 7 a.m. PDT",1689,1664,1152,-537
BANC,"4/5/2016 8 a.m. PDT",1754,1739,1375,-379
BANC,"4/5/2016 9 a.m. PDT",1785,1751,1140,-645
BANC,"4/5/2016 10 a.m. PDT",1802,1760,1128,-674
BANC,"4/5/2016 11 a.m. PDT",1811,1807,1265,-546
BANC,"4/5/2016 12 p.m. PDT",1843,1838,1300,-543
BANC,"4/5/2016 1 p.m. PDT",1856,1868,1311,-545
BANC,"4/5/2016 2 p.m. PDT",1904,1904,1274,-630
BANC,"4/5/2016 3 p.m. PDT",1931,1938,1323,-608
BANC,"4/5/2016 4 p.m. PDT",1969,1968,1332,-637
BANC,"4/5/2016 5 p.m. PDT",1982,2007,1315,-667
BANC,"4/5/2016 6 p.m. PDT",2003,2015,1339,-664
BANC,"4/5/2016 7 p.m. PDT",2021,1993,1466,-555
BANC,"4/5/2016 8 p.m. PDT",2044,1999,1528,-516
BANC,"4/5/2016 9 p.m. PDT",2100,2082,1587,-513
BANC,"4/5/2016 10 p.m. PDT",1987,1959,1345,-642
BANC,"4/5/2016 11 p.m. PDT",1790,1780,1198,-592
BANC,"4/6/2016 12 a.m. PDT",1606,1618,1007,-599
BANC,"4/6/2016 1 a.m. PDT",1504,1509,999,-505
BANC,"4/6/2016 2 a.m. PDT",1413,1426,882,-531
BANC,"4/6/2016 3 a.m. PDT",1387,1380,885,-502
BANC,"4/6/2016 4 a.m. PDT",1379,1361,871,-508
BANC,"4/6/2016 5 a.m. PDT",1405,1393,937,-468
BANC,"4/6/2016 6 a.m. PDT",1504,1493,988,-516
BANC,"4/6/2016 7 a.m. PDT",1659,1625,1219,-440
BANC,"4/6/2016 8 a.m. PDT",1740,1703,1307,-433
BANC,"4/6/2016 9 a.m. PDT",1790,1751,1227,-563
BANC,"4/6/2016 10 a.m. PDT",1833,1806,1191,-642
BANC,"4/6/2016 11 a.m. PDT",1885,1867,1280,-605
BANC,"4/6/2016 12 p.m. PDT",1926,1923,1299,-627
BANC,"4/6/2016 1 p.m. PDT",1981,1959,1358,-623
BANC,"4/6/2016 2 p.m. PDT",2065,2019,1423,-642
BANC,"4/6/2016 3 p.m. PDT",2128,2078,1455,-673
BANC,"4/6/2016 4 p.m. PDT",2187,2127,1504,-683
BANC,"4/6/2016 5 p.m. PDT",2243,2172,1540,-703
BANC,"4/6/2016 6 p.m. PDT",2277,2196,1421,-856
BANC,"4/6/2016 7 p.m. PDT",2243,2149,1553,-690
BANC,"4/6/2016 8 p.m. PDT",2258,2129,1759,-499
BANC,"4/6/2016 9 p.m. PDT",2267,2177,1691,-576
BANC,"4/6/2016 10 p.m. PDT",2132,2052,1329,-803
BANC,"4/6/2016 11 p.m. PDT",1918,1857,1217,-701
BANC,"4/7/2016 12 a.m. PDT",1720,1673,1032,-688
BANC,"4/7/2016 1 a.m. PDT",1570,1500,898,-672
BANC,"4/7/2016 2 a.m. PDT",1491,1433,870,-621
BANC,"4/7/2016 3 a.m. PDT",1442,1389,821,-621
BANC,"4/7/2016 4 a.m. PDT",1410,1378,813,-597
BANC,"4/7/2016 5 a.m. PDT",1436,1412,834,-602
BANC,"4/7/2016 6 a.m. PDT",1521,1501,892,-629
BANC,"4/7/2016 7 a.m. PDT",1681,1635,1038,-643
BANC,"4/7/2016 8 a.m. PDT",1751,1711,1254,-497
BANC,"4/7/2016 9 a.m. PDT",1789,1747,1092,-697
BANC,"4/7/2016 10 a.m. PDT",1858,1803,1082,-776
BANC,"4/7/2016 11 a.m. PDT",1906,1863,1132,-774
BANC,"4/7/2016 12 p.m. PDT",1932,1910,1155,-777
BANC,"4/7/2016 1 p.m. PDT",1974,1956,1198,-776
BANC,"4/7/2016 2 p.m. PDT",2019,2008,1187,-832
BANC,"4/7/2016 3 p.m. PDT",2022,2052,1191,-831
BANC,"4/7/2016 4 p.m. PDT",2037,2102,1200,-837
BANC,"4/7/2016 5 p.m. PDT",2031,2135,1145,-886
BANC,"4/7/2016 6 p.m. PDT",2015,2120,1189,-826
BANC,"4/7/2016 7 p.m. PDT",1972,2067,1409,-563
BANC,"4/7/2016 8 p.m. PDT",2003,2059,1581,-422
BANC,"4/7/2016 9 p.m. PDT",2066,2114,1561,-505
BANC,"4/7/2016 10 p.m. PDT",1952,1987,1316,-636
BANC,"4/7/2016 11 p.m. PDT",1784,1808,1142,-642
BANC,"4/8/2016 12 a.m. PDT",1605,1632,975,-630
BANC,"4/8/2016 1 a.m. PDT",1469,1473,951,-518
BANC,"4/8/2016 2 a.m. PDT",1425,1404,950,-475
BANC,"4/8/2016 3 a.m. PDT",1385,1367,929,-456
BANC,"4/8/2016 4 a.m. PDT",1367,1360,896,-471
BANC,"4/8/2016 5 a.m. PDT",1400,1389,924,-476
BANC,"4/8/2016 6 a.m. PDT",1499,1489,1018,-481
BANC,"4/8/2016 7 a.m. PDT",1672,1633,1109,-563
BANC,"4/8/2016 8 a.m. PDT",1753,1721,1230,-523
BANC,"4/8/2016 9 a.m. PDT",1773,1757,1270,-503
BANC,"4/8/2016 10 a.m. PDT",1811,1783,1289,-522
BANC,"4/8/2016 11 a.m. PDT",1823,1823,1236,-587
BANC,"4/8/2016 12 p.m. PDT",1862,1833,1290,-572
BANC,"4/8/2016 1 p.m. PDT",1864,1836,1237,-627
BANC,"4/8/2016 2 p.m. PDT",1925,1841,1289,-636
BANC,"4/8/2016 3 p.m. PDT",1942,1843,1257,-685
BANC,"4/8/2016 4 p.m. PDT",1951,1842,1270,-681
BANC,"4/8/2016 5 p.m. PDT",1958,1842,1256,-702
BANC,"4/8/2016 6 p.m. PDT",1946,1828,1252,-694
BANC,"4/8/2016 7 p.m. PDT",1909,1817,1440,-469
BANC,"4/8/2016 8 p.m. PDT",1964,1882,1499,-465
BANC,"4/8/2016 9 p.m. PDT",1994,1940,1554,-440
BANC,"4/8/2016 10 p.m. PDT",1899,1855,1338,-561
BANC,"4/8/2016 11 p.m. PDT",1781,1719,1290,-491
BANC,"4/9/2016 12 a.m. PDT",1619,1575,1089,-530
BANC,"4/9/2016 1 a.m. PDT",1497,1481,1032,-465
BANC,"4/9/2016 2 a.m. PDT",1416,1398,977,-439
BANC,"4/9/2016 3 a.m. PDT",1381,1353,936,-445
BANC,"4/9/2016 4 a.m. PDT",1357,1330,933,-424
BANC,"4/9/2016 5 a.m. PDT",1374,1336,952,-422
BANC,"4/9/2016 6 a.m. PDT",1392,1375,966,-426
BANC,"4/9/2016 7 a.m. PDT",1450,1424,970,-480
BANC,"4/9/2016 8 a.m. PDT",1497,1472,979,-518
BANC,"4/9/2016 9 a.m. PDT",1600,1558,1062,-538
BANC,"4/9/2016 10 a.m. PDT",1697,1615,1170,-527
BANC,"4/9/2016 11 a.m. PDT",1762,1663,1263,-499
BANC,"4/9/2016 12 p.m. PDT",1794,1667,1210,-584
BANC,"4/9/2016 1 p.m. PDT",1771,1671,1068,-703
BANC,"4/9/2016 2 p.m. PDT",1791,1655,1072,-719
BANC,"4/9/2016 3 p.m. PDT",1726,1645,986,-740
BANC,"4/9/2016 4 p.m. PDT",1708,1642,1008,-700
BANC,"4/9/2016 5 p.m. PDT",1699,1655,1055,-644
BANC,"4/9/2016 6 p.m. PDT",1711,1667,1159,-552
BANC,"4/9/2016 7 p.m. PDT",1724,1692,1308,-416
BANC,"4/9/2016 8 p.m. PDT",1793,1771,1469,-324
BANC,"4/9/2016 9 p.m. PDT",1826,1846,1525,-301
BANC,"4/9/2016 10 p.m. PDT",1763,1784,1230,-533
BANC,"4/9/2016 11 p.m. PDT",1667,1677,1133,-534
BANC,"4/10/2016 12 a.m. PDT",1555,1556,984,-571
BANC,"4/10/2016 1 a.m. PDT",1456,1443,883,-573
BANC,"4/10/2016 2 a.m. PDT",1398,1372,954,-444
BANC,"4/10/2016 3 a.m. PDT",1365,1326,994,-371
BANC,"4/10/2016 4 a.m. PDT",1341,1305,894,-447
BANC,"4/10/2016 5 a.m. PDT",1339,1310,896,-443
BANC,"4/10/2016 6 a.m. PDT",1360,1337,905,-455
BANC,"4/10/2016 7 a.m. PDT",1412,1386,992,-420
BANC,"4/10/2016 8 a.m. PDT",1436,1418,1022,-414
BANC,"4/10/2016 9 a.m. PDT",1520,1483,1061,-459
BANC,"4/10/2016 10 a.m. PDT",1598,1540,1085,-513
BANC,"4/10/2016 11 a.m. PDT",1651,1584,1105,-546
BANC,"4/10/2016 12 p.m. PDT",1694,1597,1144,-550
BANC,"4/10/2016 1 p.m. PDT",1692,1602,1150,-542
BANC,"4/10/2016 2 p.m. PDT",1660,1620,1124,-536
BANC,"4/10/2016 3 p.m. PDT",1646,1621,1112,-534
BANC,"4/10/2016 4 p.m. PDT",1682,1633,1147,-535
BANC,"4/10/2016 5 p.m. PDT",1692,1662,1136,-556
BANC,"4/10/2016 6 p.m. PDT",1713,1684,1328,-385
BANC,"4/10/2016 7 p.m. PDT",1743,1715,1509,-234
BANC,"4/10/2016 8 p.m. PDT",1806,1807,1553,-253
BANC,"4/10/2016 9 p.m. PDT",1906,1880,1619,-287
BANC,"4/10/2016 10 p.m. PDT",1814,1797,1504,-310
BANC,"4/10/2016 11 p.m. PDT",1687,1666,1122,-565
BANC,"4/11/2016 12 a.m. PDT",1544,1525,1094,-450
BANC,"4/11/2016 1 a.m. PDT",1449,1435,967,-482
BANC,"4/11/2016 2 a.m. PDT",1388,1362,903,-485
BANC,"4/11/2016 3 a.m. PDT",1364,1337,881,-483
BANC,"4/11/2016 4 a.m. PDT",1362,1332,869,-493
BANC,"4/11/2016 5 a.m. PDT",1395,1365,843,-552
BANC,"4/11/2016 6 a.m. PDT",1496,1472,950,-546
BANC,"4/11/2016 7 a.m. PDT",1674,1636,1283,-391
BANC,"4/11/2016 8 a.m. PDT",1753,1709,1346,-407
BANC,"4/11/2016 9 a.m. PDT",1777,1740,1232,-545
BANC,"4/11/2016 10 a.m. PDT",1799,1761,1160,-639
BANC,"4/11/2016 11 a.m. PDT",1853,1800,1273,-580
BANC,"4/11/2016 12 p.m. PDT",1871,1820,1304,-567
BANC,"4/11/2016 1 p.m. PDT",1864,1822,1262,-602
BANC,"4/11/2016 2 p.m. PDT",1879,1829,1288,-591
BANC,"4/11/2016 3 p.m. PDT",1878,1829,1247,-631
BANC,"4/11/2016 4 p.m. PDT",1878,1827,1239,-639
BANC,"4/11/2016 5 p.m. PDT",1874,1839,1171,-703
BANC,"4/11/2016 6 p.m. PDT",1885,1839,1208,-677
BANC,"4/11/2016 7 p.m. PDT",1878,1831,1280,-598
BANC,"4/11/2016 8 p.m. PDT",1943,1886,1457,-486
BANC,"4/11/2016 9 p.m. PDT",2031,1968,1566,-465
BANC,"4/11/2016 10 p.m. PDT",1917,1861,1425,-492
BANC,"4/11/2016 11 p.m. PDT",1765,1720,1230,-535
BANC,"4/12/2016 12 a.m. PDT",1598,1568,1035,-563
BANC,"4/12/2016 1 a.m. PDT",1487,1471,906,-581
BANC,"4/12/2016 2 a.m. PDT",1405,1393,794,-611
BANC,"4/12/2016 3 a.m. PDT",1390,1363,800,-590
BANC,"4/12/2016 4 a.m. PDT",1389,1356,796,-593
BANC,"4/12/2016 5 a.m. PDT",1416,1381,810,-606
BANC,"4/12/2016 6 a.m. PDT",1515,1488,921,-594
BANC,"4/12/2016 7 a.m. PDT",1670,1644,1182,-488
BANC,"4/12/2016 8 a.m. PDT",1765,1720,1286,-479
BANC,"4/12/2016 9 a.m. PDT",1764,1758,1226,-538
BANC,"4/12/2016 10 a.m. PDT",1807,1771,1138,-669
BANC,"4/12/2016 11 a.m. PDT",1819,1810,1106,-713
BANC,"4/12/2016 12 p.m. PDT",1827,1824,1151,-676
BANC,"4/12/2016 1 p.m. PDT",1855,1830,1192,-663
BANC,"4/12/2016 2 p.m. PDT",1838,1835,1172,-666
BANC,"4/12/2016 3 p.m. PDT",1834,1845,1171,-663
BANC,"4/12/2016 4 p.m. PDT",1839,1832,1206,-633
BANC,"4/12/2016 5 p.m. PDT",1849,1833,1241,-608
BANC,"4/12/2016 6 p.m. PDT",1863,1842,1313,-550
BANC,"4/12/2016 7 p.m. PDT",1852,1835,1238,-614
BANC,"4/12/2016 8 p.m. PDT",1911,1885,1390,-521
BANC,"4/12/2016 9 p.m. PDT",1999,1957,1512,-487
BANC,"4/12/2016 10 p.m. PDT",1901,1866,1401,-500
BANC,"4/12/2016 11 p.m. PDT",1741,1726,1113,-628
BANC,"4/13/2016 12 a.m. PDT",1591,1575,943,-648
BANC,"4/13/2016 1 a.m. PDT",1462,1471,839,-623
BANC,"4/13/2016 2 a.m. PDT",1390,1404,778,-612
BANC,"4/13/2016 3 a.m. PDT",1367,1371,755,-612
BANC,"4/13/2016 4 a.m. PDT",1366,1357,694,-672
BANC,"4/13/2016 5 a.m. PDT",1418,1391,810,-608
BANC,"4/13/2016 6 a.m. PDT",1534,1495,956,-578
BANC,"4/13/2016 7 a.m. PDT",1693,1650,1144,-549
BANC,"4/13/2016 8 a.m. PDT",1785,1728,1365,-420
BANC,"4/13/2016 9 a.m. PDT",1789,1758,1160,-629
BANC,"4/13/2016 10 a.m. PDT",1804,1778,1156,-648
BANC,"4/13/2016 11 a.m. PDT",1804,1808,1074,-730
BANC,"4/13/2016 12 p.m. PDT",1793,1821,1106,-687
BANC,"4/13/2016 1 p.m. PDT",1814,1835,1193,-621
BANC,"4/13/2016 2 p.m. PDT",1811,1844,1116,-695
BANC,"4/13/2016 3 p.m. PDT",1839,1846,1088,-751
BANC,"4/13/2016 4 p.m. PDT",1842,1837,1075,-767
BANC,"4/13/2016 5 p.m. PDT",1855,1851,1157,-698
BANC,"4/13/2016 6 p.m. PDT",1825,1847,1080,-745
BANC,"4/13/2016 7 p.m. PDT",1837,1835,1318,-519
BANC,"4/13/2016 8 p.m. PDT",1894,1889,1565,-329
BANC,"4/13/2016 9 p.m. PDT",1996,1963,1710,-286
BANC,"4/13/2016 10 p.m. PDT",1900,1871,1507,-393
BANC,"4/13/2016 11 p.m. PDT",1747,1731,1148,-599
BANC,"4/14/2016 12 a.m. PDT",1596,1591,934,-662
BANC,"4/14/2016 1 a.m. PDT",1471,1463,689,-782
BANC,"4/14/2016 2 a.m. PDT",1397,1396,634,-763
BANC,"4/14/2016 3 a.m. PDT",1377,1363,588,-789
BANC,"4/14/2016 4 a.m. PDT",1370,1351,540,-830
BANC,"4/14/2016 5 a.m. PDT",1411,1386,594,-817
BANC,"4/14/2016 6 a.m. PDT",1514,1490,756,-758
BANC,"4/14/2016 7 a.m. PDT",1696,1654,1239,-457
BANC,"4/14/2016 8 a.m. PDT",1771,1742,1262,-509
BANC,"4/14/2016 9 a.m. PDT",1786,1768,1108,-678
BANC,"4/14/2016 10 a.m. PDT",1781,1800,969,-812
BANC,"4/14/2016 11 a.m. PDT",1794,1824,1071,-723
BANC,"4/14/2016 12 p.m. PDT",1793,1830,1082,-711
BANC,"4/14/2016 1 p.m. PDT",1791,1848,1051,-740
BANC,"4/14/2016 2 p.m. PDT",1769,1838,1052,-717
BANC,"4/14/2016 3 p.m. PDT",1789,1840,1035,-754
BANC,"4/14/2016 4 p.m. PDT",1784,1832,1065,-719
BANC,"4/14/2016 5 p.m. PDT",1799,1831,1170,-629
BANC,"4/14/2016 6 p.m. PDT",1824,1836,1239,-585
BANC,"4/14/2016 7 p.m. PDT",1806,1825,1286,-520
BANC,"4/14/2016 8 p.m. PDT",1860,1872,1403,-457
BANC,"4/14/2016 9 p.m. PDT",1974,1973,1547,-427
BANC,"4/14/2016 10 p.m. PDT",1884,1890,1390,-494
BANC,"4/14/2016 11 p.m. PDT",1755,1736,1003,-752
BANC,"4/15/2016 12 a.m. PDT",1598,1577,782,-816
BANC,"4/15/2016 1 a.m. PDT",1485,1472,660,-825
BANC,"4/15/2016 2 a.m. PDT",1417,1414,562,-855
BANC,"4/15/2016 3 a.m. PDT",1393,1383,579,-814
BANC,"4/15/2016 4 a.m. PDT",1394,1376,583,-811
BANC,"4/15/2016 5 a.m. PDT",1449,1419,630,-819
BANC,"4/15/2016 6 a.m. PDT",1563,1527,743,-820
BANC,"4/15/2016 7 a.m. PDT",1712,1706,1205,-507
BANC,"4/15/2016 8 a.m. PDT",1803,1783,1361,-442
BANC,"4/15/2016 9 a.m. PDT",1799,1784,1123,-676
BANC,"4/15/2016 10 a.m. PDT",1794,1786,1138,-656
BANC,"4/15/2016 11 a.m. PDT",1791,1792,1139,-652
BANC,"4/15/2016 12 p.m. PDT",1795,1804,1113,-682
BANC,"4/15/2016 1 p.m. PDT",1777,1805,1094,-683
BANC,"4/15/2016 2 p.m. PDT",1751,1820,1090,-661
BANC,"4/15/2016 3 p.m. PDT",1783,1820,1143,-640
BANC,"4/15/2016 4 p.m. PDT",1762,1828,1049,-713
BANC,"4/15/2016 5 p.m. PDT",1793,1838,1018,-775
BANC,"4/15/2016 6 p.m. PDT",1793,1851,1076,-717
BANC,"4/15/2016 7 p.m. PDT",1782,1872,1269,-513
BANC,"4/15/2016 8 p.m. PDT",1826,1926,1381,-445
BANC,"4/15/2016 9 p.m. PDT",1939,1966,1473,-466
BANC,"4/15/2016 10 p.m. PDT",1869,1868,1399,-470
BANC,"4/15/2016 11 p.m. PDT",1734,1731,1028,-706
BANC,"4/16/2016 12 a.m. PDT",1594,1590,794,-800
BANC,"4/16/2016 1 a.m. PDT",1476,1482,730,-746
BANC,"4/16/2016 2 a.m. PDT",1411,1409,684,-727
BANC,"4/16/2016 3 a.m. PDT",1368,1360,593,-775
BANC,"4/16/2016 4 a.m. PDT",1351,1330,587,-764
BANC,"4/16/2016 5 a.m. PDT",1358,1341,650,-708
BANC,"4/16/2016 6 a.m. PDT",1394,1376,683,-711
BANC,"4/16/2016 7 a.m. PDT",1444,1402,871,-573
BANC,"4/16/2016 8 a.m. PDT",1479,1460,947,-532
BANC,"4/16/2016 9 a.m. PDT",1538,1546,929,-609
BANC,"4/16/2016 10 a.m. PDT",1589,1628,992,-597
BANC,"4/16/2016 11 a.m. PDT",1628,1683,995,-633
BANC,"4/16/2016 12 p.m. PDT",1613,1709,976,-637
BANC,"4/16/2016 1 p.m. PDT",1630,1728,981,-649
BANC,"4/16/2016 2 p.m. PDT",1643,1761,1008,-635
BANC,"4/16/2016 3 p.m. PDT",1676,1791,1081,-595
BANC,"4/16/2016 4 p.m. PDT",1717,1843,1103,-614
BANC,"4/16/2016 5 p.m. PDT",1786,1904,1190,-596
BANC,"4/16/2016 6 p.m. PDT",1817,1951,1233,-584
BANC,"4/16/2016 7 p.m. PDT",1859,1954,1510,-349
BANC,"4/16/2016 8 p.m. PDT",1897,1954,1609,-288
BANC,"4/16/2016 9 p.m. PDT",1971,2025,1657,-314
BANC,"4/16/2016 10 p.m. PDT",1896,1950,1567,-329
BANC,"4/16/2016 11 p.m. PDT",1760,1799,1235,-525
BANC,"4/17/2016 12 a.m. PDT",1637,1650,954,-683
BANC,"4/17/2016 1 a.m. PDT",1509,1490,934,-575
BANC,"4/17/2016 2 a.m. PDT",1418,1414,860,-558
BANC,"4/17/2016 3 a.m. PDT",1354,1362,813,-541
BANC,"4/17/2016 4 a.m. PDT",1333,1337,798,-535
BANC,"4/17/2016 5 a.m. PDT",1335,1334,798,-537
BANC,"4/17/2016 6 a.m. PDT",1344,1359,811,-533
BANC,"4/17/2016 7 a.m. PDT",1358,1370,869,-489
BANC,"4/17/2016 8 a.m. PDT",1405,1408,964,-441
BANC,"4/17/2016 9 a.m. PDT",1482,1501,973,-509
BANC,"4/17/2016 10 a.m. PDT",1563,1582,991,-572
BANC,"4/17/2016 11 a.m. PDT",1605,1647,1107,-498
BANC,"4/17/2016 12 p.m. PDT",1650,1698,1133,-517
BANC,"4/17/2016 1 p.m. PDT",1711,1739,1158,-553
BANC,"4/17/2016 2 p.m. PDT",1734,1784,1149,-585
BANC,"4/17/2016 3 p.m. PDT",1795,1830,1236,-559
BANC,"4/17/2016 4 p.m. PDT",1887,1882,1288,-599
BANC,"4/17/2016 5 p.m. PDT",1980,1951,1361,-619
BANC,"4/17/2016 6 p.m. PDT",2047,2004,1421,-626
BANC,"4/17/2016 7 p.m. PDT",2100,2027,1602,-498
BANC,"4/17/2016 8 p.m. PDT",2110,2033,1629,-481
BANC,"4/17/2016 9 p.m. PDT",2183,2106,1784,-399
BANC,"4/17/2016 10 p.m. PDT",2044,2007,1588,-456
BANC,"4/17/2016 11 p.m. PDT",1852,1822,1429,-423
BANC,"4/18/2016 12 a.m. PDT",1646,1646,996,-650
BANC,"4/18/2016 1 a.m. PDT",1517,1495,896,-621
BANC,"4/18/2016 2 a.m. PDT",1430,1430,858,-572
BANC,"4/18/2016 3 a.m. PDT",1398,1384,840,-558
BANC,"4/18/2016 4 a.m. PDT",1388,1369,817,-571
BANC,"4/18/2016 5 a.m. PDT",1417,1395,839,-578
BANC,"4/18/2016 6 a.m. PDT",1519,1498,916,-603
BANC,"4/18/2016 7 a.m. PDT",1642,1633,1099,-543
BANC,"4/18/2016 8 a.m. PDT",1723,1704,1136,-587
BANC,"4/18/2016 9 a.m. PDT",1804,1762,1074,-730
BANC,"4/18/2016 10 a.m. PDT",1865,1830,1076,-789
BANC,"4/18/2016 11 a.m. PDT",1954,1895,1176,-778
BANC,"4/18/2016 12 p.m. PDT",2016,1956,1217,-799
BANC,"4/18/2016 1 p.m. PDT",2075,2023,1314,-761
BANC,"4/18/2016 2 p.m. PDT",2198,2093,1432,-766
BANC,"4/18/2016 3 p.m. PDT",2269,2160,1460,-809
BANC,"4/18/2016 4 p.m. PDT",2353,2217,1469,-884
BANC,"4/18/2016 5 p.m. PDT",2436,2270,1543,-893
BANC,"4/18/2016 6 p.m. PDT",2473,2281,1585,-888
BANC,"4/18/2016 7 p.m. PDT",2427,2244,1430,-997
BANC,"4/18/2016 8 p.m. PDT",2359,2208,1600,-759
BANC,"4/18/2016 9 p.m. PDT",2377,2252,1657,-720
BANC,"4/18/2016 10 p.m. PDT",2206,2121,1276,-930
BANC,"4/18/2016 11 p.m. PDT",1965,1908,1226,-739
BANC,"4/19/2016 12 a.m. PDT",1737,1711,1068,-669
BANC,"4/19/2016 1 a.m. PDT",1571,1562,859,-712
BANC,"4/19/2016 2 a.m. PDT",1466,1478,733,-733
BANC,"4/19/2016 3 a.m. PDT",1417,1418,754,-663
BANC,"4/19/2016 4 a.m. PDT",1419,1397,835,-584
BANC,"4/19/2016 5 a.m. PDT",1452,1418,860,-592
BANC,"4/19/2016 6 a.m. PDT",1533,1511,1023,-510
BANC,"4/19/2016 7 a.m. PDT",1675,1616,1386,-289
BANC,"4/19/2016 8 a.m. PDT",1758,1695,1453,-305
BANC,"4/19/2016 9 a.m. PDT",1815,1750,1443,-372
BANC,"4/19/2016 10 a.m. PDT",1869,1814,1405,-464
BANC,"4/19/2016 11 a.m. PDT",1934,1891,1429,-505
BANC,"4/19/2016 12 p.m. PDT",2000,1957,1354,-646
BANC,"4/19/2016 1 p.m. PDT",2089,2014,1387,-702
BANC,"4/19/2016 2 p.m. PDT",2163,2093,1442,-721
BANC,"4/19/2016 3 p.m. PDT",2259,2156,1464,-795
BANC,"4/19/2016 4 p.m. PDT",2346,2209,1579,-767
BANC,"4/19/2016 5 p.m. PDT",2397,2260,1573,-824
BANC,"4/19/2016 6 p.m. PDT",2391,2250,1588,-803
BANC,"4/19/2016 7 p.m. PDT",2297,2182,1361,-936
BANC,"4/19/2016 8 p.m. PDT",2248,2139,1437,-811
BANC,"4/19/2016 9 p.m. PDT",2294,2181,1609,-685
BANC,"4/19/2016 10 p.m. PDT",2134,2055,1459,-675
BANC,"4/19/2016 11 p.m. PDT",1914,1870,1230,-684
BANC,"4/20/2016 12 a.m. PDT",1696,1679,1104,-592
BANC,"4/20/2016 1 a.m. PDT",1557,1529,1097,-460
BANC,"4/20/2016 2 a.m. PDT",1466,1448,1031,-435
BANC,"4/20/2016 3 a.m. PDT",1432,1400,998,-434
BANC,"4/20/2016 4 a.m. PDT",1420,1382,945,-475
BANC,"4/20/2016 5 a.m. PDT",1433,1407,990,-443
BANC,"4/20/2016 6 a.m. PDT",1528,1509,1088,-440
BANC,"4/20/2016 7 a.m. PDT",1660,1642,1386,-274
BANC,"4/20/2016 8 a.m. PDT",1750,1720,1535,-215
BANC,"4/20/2016 9 a.m. PDT",1793,1757,1347,-446
BANC,"4/20/2016 10 a.m. PDT",1843,1811,1323,-520
BANC,"4/20/2016 11 a.m. PDT",1883,1865,1358,-525
BANC,"4/20/2016 12 p.m. PDT",1948,1908,1415,-533
BANC,"4/20/2016 1 p.m. PDT",1986,1941,1338,-648
BANC,"4/20/2016 2 p.m. PDT",2044,1979,1373,-671
BANC,"4/20/2016 3 p.m. PDT",2088,2016,1381,-707
BANC,"4/20/2016 4 p.m. PDT",2106,2039,1401,-705
BANC,"4/20/2016 5 p.m. PDT",2142,2078,1396,-746
BANC,"4/20/2016 6 p.m. PDT",2157,2082,1534,-623
BANC,"4/20/2016 7 p.m. PDT",2145,2055,1740,-405
BANC,"4/20/2016 8 p.m. PDT",2097,2061,1762,-335
BANC,"4/20/2016 9 p.m. PDT",2135,2141,1781,-354
BANC,"4/20/2016 10 p.m. PDT",2058,2028,1507,-551
BANC,"4/20/2016 11 p.m. PDT",1865,1847,1329,-536
BANC,"4/21/2016 12 a.m. PDT",1682,1669,1186,-496
BANC,"4/21/2016 1 a.m. PDT",1542,1518,973,-569
BANC,"4/21/2016 2 a.m. PDT",1451,1438,899,-552
BANC,"4/21/2016 3 a.m. PDT",1414,1397,824,-590
BANC,"4/21/2016 4 a.m. PDT",1394,1381,797,-597
BANC,"4/21/2016 5 a.m. PDT",1433,1408,810,-623
BANC,"4/21/2016 6 a.m. PDT",1547,1503,1014,-533
BANC,"4/21/2016 7 a.m. PDT",1674,1640,1481,-193
BANC,"4/21/2016 8 a.m. PDT",1744,1721,1470,-274
BANC,"4/21/2016 9 a.m. PDT",1805,1758,1319,-486
BANC,"4/21/2016 10 a.m. PDT",1856,1809,1341,-515
BANC,"4/21/2016 11 a.m. PDT",1903,1862,1326,-577
BANC,"4/21/2016 12 p.m. PDT",1935,1911,1294,-641
BANC,"4/21/2016 1 p.m. PDT",1968,1948,1316,-652
BANC,"4/21/2016 2 p.m. PDT",2004,1990,1353,-651
BANC,"4/21/2016 3 p.m. PDT",2030,2031,1384,-646
BANC,"4/21/2016 4 p.m. PDT",2017,2051,1423,-594
BANC,"4/21/2016 5 p.m. PDT",2006,2074,1424,-582
BANC,"4/21/2016 6 p.m. PDT",2017,2051,1429,-588
BANC,"4/21/2016 7 p.m. PDT",1970,2013,1633,-337
BANC,"4/21/2016 8 p.m. PDT",1960,2013,1681,-279
BANC,"4/21/2016 9 p.m. PDT",2056,2081,1797,-259
BANC,"4/21/2016 10 p.m. PDT",1954,1968,1633,-321
BANC,"4/21/2016 11 p.m. PDT",1805,1794,1350,-455
BANC,"4/22/2016 12 a.m. PDT",1636,1623,1157,-479
BANC,"4/22/2016 1 a.m. PDT",1532,1497,1163,-369
BANC,"4/22/2016 2 a.m. PDT",1439,1430,928,-511
BANC,"4/22/2016 3 a.m. PDT",1400,1389,876,-524
BANC,"4/22/2016 4 a.m. PDT",1385,1376,856,-529
BANC,"4/22/2016 5 a.m. PDT",1445,1400,940,-505
BANC,"4/22/2016 6 a.m. PDT",1532,1505,1125,-407
BANC,"4/22/2016 7 a.m. PDT",1684,1659,1360,-324
BANC,"4/22/2016 8 a.m. PDT",1799,1745,1482,-317
BANC,"4/22/2016 9 a.m. PDT",1839,1766,1434,-405
BANC,"4/22/2016 10 a.m. PDT",1876,1793,1346,-530
BANC,"4/22/2016 11 a.m. PDT",1890,1824,1352,-538
BANC,"4/22/2016 12 p.m. PDT",1915,1841,1464,-451
BANC,"4/22/2016 1 p.m. PDT",1882,1849,1445,-437
BANC,"4/22/2016 2 p.m. PDT",1875,1866,1474,-401
BANC,"4/22/2016 3 p.m. PDT",1852,1872,1434,-418
BANC,"4/22/2016 4 p.m. PDT",1813,1860,1397,-416
BANC,"4/22/2016 5 p.m. PDT",1788,1868,1184,-604
BANC,"4/22/2016 6 p.m. PDT",1769,1861,1241,-528
BANC,"4/22/2016 7 p.m. PDT",1769,1845,1521,-248
BANC,"4/22/2016 8 p.m. PDT",1743,1898,1572,-171
BANC,"4/22/2016 9 p.m. PDT",1883,1955,1680,-203
BANC,"4/22/2016 10 p.m. PDT",1827,1873,1573,-254
BANC,"4/22/2016 11 p.m. PDT",1735,1744,1429,-306
BANC,"4/23/2016 12 a.m. PDT",1592,1592,1163,-429
BANC,"4/23/2016 1 a.m. PDT",1484,1485,941,-543
BANC,"4/23/2016 2 a.m. PDT",1420,1410,872,-548
BANC,"4/23/2016 3 a.m. PDT",1385,1358,839,-546
BANC,"4/23/2016 4 a.m. PDT",1361,1331,805,-556
BANC,"4/23/2016 5 a.m. PDT",1370,1334,801,-569
BANC,"4/23/2016 6 a.m. PDT",1418,1373,861,-557
BANC,"4/23/2016 7 a.m. PDT",1432,1427,983,-449
BANC,"4/23/2016 8 a.m. PDT",1503,1474,1127,-376
BANC,"4/23/2016 9 a.m. PDT",1581,1564,1124,-457
BANC,"4/23/2016 10 a.m. PDT",1615,1616,1190,-425
BANC,"4/23/2016 11 a.m. PDT",1632,1653,1224,-408
BANC,"4/23/2016 12 p.m. PDT",1631,1675,1205,-426
BANC,"4/23/2016 1 p.m. PDT",1634,1681,1132,-502
BANC,"4/23/2016 2 p.m. PDT",1618,1684,1104,-514
BANC,"4/23/2016 3 p.m. PDT",1643,1693,1264,-379
BANC,"4/23/2016 4 p.m. PDT",1615,1703,1245,-370
BANC,"4/23/2016 5 p.m. PDT",1630,1729,1270,-360
BANC,"4/23/2016 6 p.m. PDT",1681,1754,1135,-546
BANC,"4/23/2016 7 p.m. PDT",1700,1759,1311,-389
BANC,"4/23/2016 8 p.m. PDT",1752,1807,1488,-264
BANC,"4/23/2016 9 p.m. PDT",1860,1897,1607,-253
BANC,"4/23/2016 10 p.m. PDT",1817,1827,1494,-323
BANC,"4/23/2016 11 p.m. PDT",1712,1707,1183,-529
BANC,"4/24/2016 12 a.m. PDT",1567,1575,994,-573
BANC,"4/24/2016 1 a.m. PDT",1457,1462,871,-586
BANC,"4/24/2016 2 a.m. PDT",1397,1396,855,-542
BANC,"4/24/2016 3 a.m. PDT",1354,1360,816,-538
BANC,"4/24/2016 4 a.m. PDT",1336,1328,821,-515
BANC,"4/24/2016 5 a.m. PDT",1332,1335,813,-519
BANC,"4/24/2016 6 a.m. PDT",1352,1374,812,-540
BANC,"4/24/2016 7 a.m. PDT",1397,1428,954,-443
BANC,"4/24/2016 8 a.m. PDT",1427,1474,959,-468
BANC,"4/24/2016 9 a.m. PDT",1501,1562,1022,-479
BANC,"4/24/2016 10 a.m. PDT",1557,1622,1071,-486
BANC,"4/24/2016 11 a.m. PDT",1594,1665,1078,-516
BANC,"4/24/2016 12 p.m. PDT",1617,1687,1115,-502
BANC,"4/24/2016 1 p.m. PDT",1638,1691,1037,-601
BANC,"4/24/2016 2 p.m. PDT",1652,1688,1045,-607
BANC,"4/24/2016 3 p.m. PDT",1647,1700,1053,-594
BANC,"4/24/2016 4 p.m. PDT",1664,1704,1055,-609
BANC,"4/24/2016 5 p.m. PDT",1709,1736,1101,-608
BANC,"4/24/2016 6 p.m. PDT",1740,1765,1125,-615
BANC,"4/24/2016 7 p.m. PDT",1762,1796,1490,-272
BANC,"4/24/2016 8 p.m. PDT",1789,1852,1574,-215
BANC,"4/24/2016 9 p.m. PDT",1900,1925,1705,-195
BANC,"4/24/2016 10 p.m. PDT",1836,1860,1572,-264
BANC,"4/24/2016 11 p.m. PDT",1695,1724,1280,-415
BANC,"4/25/2016 12 a.m. PDT",1541,1575,976,-565
BANC,"4/25/2016 1 a.m. PDT",1450,1442,888,-562
BANC,"4/25/2016 2 a.m. PDT",1377,1391,800,-577
BANC,"4/25/2016 3 a.m. PDT",1356,1360,793,-563
BANC,"4/25/2016 4 a.m. PDT",1348,1345,761,-587
BANC,"4/25/2016 5 a.m. PDT",1395,1387,825,-570
BANC,"4/25/2016 6 a.m. PDT",1508,1500,910,-598
BANC,"4/25/2016 7 a.m. PDT",1647,1671,1197,-450
BANC,"4/25/2016 8 a.m. PDT",1739,1755,1219,-520
BANC,"4/25/2016 9 a.m. PDT",1762,1767,1175,-587
BANC,"4/25/2016 10 a.m. PDT",1774,1803,1129,-645
BANC,"4/25/2016 11 a.m. PDT",1791,1832,1331,-460
BANC,"4/25/2016 12 p.m. PDT",1801,1849,1255,-546
BANC,"4/25/2016 1 p.m. PDT",1787,1860,1122,-665
BANC,"4/25/2016 2 p.m. PDT",1793,1865,1244,-549
BANC,"4/25/2016 3 p.m. PDT",1784,1870,1037,-747
BANC,"4/25/2016 4 p.m. PDT",1785,1872,1024,-761
BANC,"4/25/2016 5 p.m. PDT",1819,1876,1065,-754
BANC,"4/25/2016 6 p.m. PDT",1852,1880,1089,-763
BANC,"4/25/2016 7 p.m. PDT",1857,1863,1290,-567
BANC,"4/25/2016 8 p.m. PDT",1884,1896,1438,-446
BANC,"4/25/2016 9 p.m. PDT",1998,1987,1641,-357
BANC,"4/25/2016 10 p.m. PDT",1900,1891,1272,-628
BANC,"4/25/2016 11 p.m. PDT",1751,1732,1174,-577
BANC,"4/26/2016 12 a.m. PDT",1579,1584,981,-598
BANC,"4/26/2016 1 a.m. PDT",1480,1470,798,-682
BANC,"4/26/2016 2 a.m. PDT",1408,1409,713,-695
BANC,"4/26/2016 3 a.m. PDT",1377,1379,683,-694
BANC,"4/26/2016 4 a.m. PDT",1391,1365,716,-675
BANC,"4/26/2016 5 a.m. PDT",1425,1405,735,-690
BANC,"4/26/2016 6 a.m. PDT",1543,1519,847,-696
BANC,"4/26/2016 7 a.m. PDT",1679,1659,1163,-516
BANC,"4/26/2016 8 a.m. PDT",1757,1740,1232,-525
BANC,"4/26/2016 9 a.m. PDT",1770,1759,1063,-707
BANC,"4/26/2016 10 a.m. PDT",1809,1778,1101,-708
BANC,"4/26/2016 11 a.m. PDT",1782,1807,1096,-686
BANC,"4/26/2016 12 p.m. PDT",1811,1818,1098,-713
BANC,"4/26/2016 1 p.m. PDT",1833,1818,1057,-776
BANC,"4/26/2016 2 p.m. PDT",1862,1819,1072,-790
BANC,"4/26/2016 3 p.m. PDT",1866,1822,1102,-764
BANC,"4/26/2016 4 p.m. PDT",1841,1829,1046,-795
BANC,"4/26/2016 5 p.m. PDT",1871,1847,1089,-782
BANC,"4/26/2016 6 p.m. PDT",1854,1837,1054,-800
BANC,"4/26/2016 7 p.m. PDT",1877,1840,1466,-411
BANC,"4/26/2016 8 p.m. PDT",1920,1875,1549,-371
BANC,"4/26/2016 9 p.m. PDT",2013,1977,1678,-335
BANC,"4/26/2016 10 p.m. PDT",1911,1886,1501,-410
BANC,"4/26/2016 11 p.m. PDT",1745,1730,1083,-662
BANC,"4/27/2016 12 a.m. PDT",1607,1584,925,-682
BANC,"4/27/2016 1 a.m. PDT",1504,1465,828,-676
BANC,"4/27/2016 2 a.m. PDT",1437,1397,744,-693
BANC,"4/27/2016 3 a.m. PDT",1382,1377,706,-676
BANC,"4/27/2016 4 a.m. PDT",1361,1362,693,-668
BANC,"4/27/2016 5 a.m. PDT",1404,1401,748,-656
BANC,"4/27/2016 6 a.m. PDT",1532,1508,872,-660
BANC,"4/27/2016 7 a.m. PDT",1666,1667,1174,-492
BANC,"4/27/2016 8 a.m. PDT",1782,1744,1174,-608
BANC,"4/27/2016 9 a.m. PDT",1767,1759,1007,-760
BANC,"4/27/2016 10 a.m. PDT",1806,1789,1055,-751
BANC,"4/27/2016 11 a.m. PDT",1850,1819,1172,-678
BANC,"4/27/2016 12 p.m. PDT",1850,1834,1158,-692
BANC,"4/27/2016 1 p.m. PDT",1860,1846,1168,-692
BANC,"4/27/2016 2 p.m. PDT",1868,1854,1152,-716
BANC,"4/27/2016 3 p.m. PDT",1841,1841,1059,-782
BANC,"4/27/2016 4 p.m. PDT",1844,1842,1062,-782
BANC,"4/27/2016 5 p.m. PDT",1858,1847,1082,-776
BANC,"4/27/2016 6 p.m. PDT",1831,1851,1040,-791
BANC,"4/27/2016 7 p.m. PDT",1827,1847,1205,-622
BANC,"4/27/2016 8 p.m. PDT",1843,1886,1302,-541
BANC,"4/27/2016 9 p.m. PDT",1947,1980,1497,-450
BANC,"4/27/2016 10 p.m. PDT",1895,1884,1364,-531
BANC,"4/27/2016 11 p.m. PDT",1749,1730,1079,-670
BANC,"4/28/2016 12 a.m. PDT",1564,1579,893,-671
BANC,"4/28/2016 1 a.m. PDT",1461,1488,984,-477
BANC,"4/28/2016 2 a.m. PDT",1413,1425,942,-471
BANC,"4/28/2016 3 a.m. PDT",1378,1380,911,-467
BANC,"4/28/2016 4 a.m. PDT",1373,1366,913,-460
BANC,"4/28/2016 5 a.m. PDT",1415,1402,934,-481
BANC,"4/28/2016 6 a.m. PDT",1532,1505,1034,-498
BANC,"4/28/2016 7 a.m. PDT",1677,1633,1383,-294
BANC,"4/28/2016 8 a.m. PDT",1766,1698,1437,-329
BANC,"4/28/2016 9 a.m. PDT",1781,1738,1280,-501
BANC,"4/28/2016 10 a.m. PDT",1790,1770,1251,-539
BANC,"4/28/2016 11 a.m. PDT",1813,1825,1304,-509
BANC,"4/28/2016 12 p.m. PDT",1826,1863,1325,-501
BANC,"4/28/2016 1 p.m. PDT",1847,1900,1249,-598
BANC,"4/28/2016 2 p.m. PDT",1879,1929,1279,-600
BANC,"4/28/2016 3 p.m. PDT",1891,1961,1283,-608
BANC,"4/28/2016 4 p.m. PDT",1911,1989,1279,-632
BANC,"4/28/2016 5 p.m. PDT",1938,2027,1284,-654
BANC,"4/28/2016 6 p.m. PDT",1969,2038,1292,-677
BANC,"4/28/2016 7 p.m. PDT",1966,2019,1431,-535
BANC,"4/28/2016 8 p.m. PDT",1960,2007,1524,-436
BANC,"4/28/2016 9 p.m. PDT",2038,2085,1654,-384
BANC,"4/28/2016 10 p.m. PDT",1963,1998,1554,-409
BANC,"4/28/2016 11 p.m. PDT",1782,1822,1357,-425
BANC,"4/29/2016 12 a.m. PDT",1624,1646,1113,-511
BANC,"4/29/2016 1 a.m. PDT",1497,1486,941,-556
BANC,"4/29/2016 2 a.m. PDT",1427,1421,847,-580
BANC,"4/29/2016 3 a.m. PDT",1389,1386,816,-573
BANC,"4/29/2016 4 a.m. PDT",1374,1370,812,-562
BANC,"4/29/2016 5 a.m. PDT",1416,1407,856,-560
BANC,"4/29/2016 6 a.m. PDT",1498,1502,978,-520
BANC,"4/29/2016 7 a.m. PDT",1636,1644,1381,-255
BANC,"4/29/2016 8 a.m. PDT",1733,1727,1506,-227
BANC,"4/29/2016 9 a.m. PDT",1754,1762,1412,-342
BANC,"4/29/2016 10 a.m. PDT",1770,1802,1308,-462
BANC,"4/29/2016 11 a.m. PDT",1799,1842,1376,-423
BANC,"4/29/2016 12 p.m. PDT",1828,1874,1408,-420
BANC,"4/29/2016 1 p.m. PDT",1843,1909,1283,-560
BANC,"4/29/2016 2 p.m. PDT",1876,1943,1291,-585
BANC,"4/29/2016 3 p.m. PDT",1888,1963,1300,-588
BANC,"4/29/2016 4 p.m. PDT",1909,1985,1295,-614
BANC,"4/29/2016 5 p.m. PDT",1949,2021,1329,-620
BANC,"4/29/2016 6 p.m. PDT",1948,2034,1455,-493
BANC,"4/29/2016 7 p.m. PDT",1926,2021,1447,-479
BANC,"4/29/2016 8 p.m. PDT",1918,2036,1644,-274
BANC,"4/29/2016 9 p.m. PDT",2017,2095,1749,-268
BANC,"4/29/2016 10 p.m. PDT",1930,1989,1694,-236
BANC,"4/29/2016 11 p.m. PDT",1805,1817,1362,-443
BANC,"4/30/2016 12 a.m. PDT",1647,1647,1212,-435
BANC,"4/30/2016 1 a.m. PDT",1538,1532,1028,-510
BANC,"4/30/2016 2 a.m. PDT",1430,1441,940,-490
BANC,"4/30/2016 3 a.m. PDT",1388,1389,909,-479
BANC,"4/30/2016 4 a.m. PDT",1367,1356,904,-463
BANC,"4/30/2016 5 a.m. PDT",1366,1359,878,-488
BANC,"4/30/2016 6 a.m. PDT",1395,1391,941,-454
BANC,"4/30/2016 7 a.m. PDT",1408,1416,1285,-123
BANC,"4/30/2016 8 a.m. PDT",1459,1458,1368,-91
BANC,"4/30/2016 9 a.m. PDT",1539,1555,1244,-295
BANC,"4/30/2016 10 a.m. PDT",1594,1632,1264,-330
BANC,"4/30/2016 11 a.m. PDT",1640,1686,1304,-336
BANC,"4/30/2016 12 p.m. PDT",1654,1710,1314,-340
BANC,"4/30/2016 1 p.m. PDT",1655,1737,1273,-382
BANC,"4/30/2016 2 p.m. PDT",1671,1759,1212,-459
BANC,"4/30/2016 3 p.m. PDT",1698,1786,1201,-497
BANC,"4/30/2016 4 p.m. PDT",1735,1835,1306,-429
BANC,"4/30/2016 5 p.m. PDT",1805,1893,1370,-435
BANC,"4/30/2016 6 p.m. PDT",1855,1939,1414,-441
BANC,"4/30/2016 7 p.m. PDT",1882,1960,1348,-534
BANC,"4/30/2016 8 p.m. PDT",1889,1966,1549,-340
BANC,"4/30/2016 9 p.m. PDT",1979,2023,1657,-322
BANC,"4/30/2016 10 p.m. PDT",1927,1944,1653,-274
BANC,"4/30/2016 11 p.m. PDT",1788,1796,1303,-485
BANC,"5/1/2016 12 a.m. PDT",1638,1654,1174,-464
