"BA Code","Timestamp (Hour Ending)","Demand (MWh)","Demand Forecast (MWh)","Net Generation (MWh)","Total Interchange (MWh)"
BANC,"11/1/2017 12 a.m. PDT",1573,1609,1052,-521
BANC,"11/1/2017 1 a.m. PDT",1453,1469,1078,-375
BANC,"11/1/2017 2 a.m. PDT",1393,1410,1030,-363
BANC,"11/1/2017 3 a.m. PDT",1362,1381,934,-428
BANC,"11/1/2017 4 a.m. PDT",1358,1374,927,-431
BANC,"11/1/2017 5 a.m. PDT",1397,1412,1028,-369
BANC,"11/1/2017 6 a.m. PDT",1499,1521,1112,-387
BANC,"11/1/2017 7 a.m. PDT",1722,1722,1345,-377
BANC,"11/1/2017 8 a.m. PDT",1831,1818,1477,-354
BANC,"11/1/2017 9 a.m. PDT",1824,1810,1312,-512
BANC,"11/1/2017 10 a.m. PDT",1811,1831,1301,-510
BANC,"11/1/2017 11 a.m. PDT",1817,1841,1277,-540
BANC,"11/1/2017 12 p.m. PDT",1809,1857,1269,-540
BANC,"11/1/2017 1 p.m. PDT",1808,1864,1252,-556
BANC,"11/1/2017 2 p.m. PDT",1810,1874,1259,-551
BANC,"11/1/2017 3 p.m. PDT",1838,1879,1284,-554
BANC,"11/1/2017 4 p.m. PDT",1832,1890,1271,-561
BANC,"11/1/2017 5 p.m. PDT",1851,1900,1508,-343
BANC,"11/1/2017 6 p.m. PDT",1901,1926,1649,-252
BANC,"11/1/2017 7 p.m. PDT",2009,2013,1793,-216
BANC,"11/1/2017 8 p.m. PDT",1949,2057,1794,-155
BANC,"11/1/2017 9 p.m. PDT",1890,1991,1750,-140
BANC,"11/1/2017 10 p.m. PDT",1788,1878,1288,-500
BANC,"11/1/2017 11 p.m. PDT",1630,1728,1157,-473
BANC,"11/2/2017 12 a.m. PDT",1538,1579,1104,-434
BANC,"11/2/2017 1 a.m. PDT",1452,1469,1001,-451
BANC,"11/2/2017 2 a.m. PDT",1398,1410,983,-415
BANC,"11/2/2017 3 a.m. PDT",1386,1382,946,-440
BANC,"11/2/2017 4 a.m. PDT",1368,1374,922,-446
BANC,"11/2/2017 5 a.m. PDT",1419,1423,997,-422
BANC,"11/2/2017 6 a.m. PDT",1524,1535,1119,-405
BANC,"11/2/2017 7 a.m. PDT",1719,1739,1294,-425
BANC,"11/2/2017 8 a.m. PDT",1860,1860,1558,-302
BANC,"11/2/2017 9 a.m. PDT",1862,1850,1379,-483
BANC,"11/2/2017 10 a.m. PDT",1892,1861,1333,-559
BANC,"11/2/2017 11 a.m. PDT",1920,1867,1382,-538
BANC,"11/2/2017 12 p.m. PDT",1905,1872,1358,-547
BANC,"11/2/2017 1 p.m. PDT",1890,1873,1306,-584
BANC,"11/2/2017 2 p.m. PDT",1881,1872,1323,-558
BANC,"11/2/2017 3 p.m. PDT",1880,1865,1351,-529
BANC,"11/2/2017 4 p.m. PDT",1856,1879,1282,-574
BANC,"11/2/2017 5 p.m. PDT",1853,1894,1372,-481
BANC,"11/2/2017 6 p.m. PDT",1895,1945,1606,-289
BANC,"11/2/2017 7 p.m. PDT",2018,2044,1766,-252
BANC,"11/2/2017 8 p.m. PDT",2005,2066,1812,-193
BANC,"11/2/2017 9 p.m. PDT",1948,2004,1725,-223
BANC,"11/2/2017 10 p.m. PDT",1847,1893,1340,-507
BANC,"11/2/2017 11 p.m. PDT",1706,1737,1226,-480
BANC,"11/3/2017 12 a.m. PDT",1569,1589,1137,-432
BANC,"11/3/2017 1 a.m. PDT",1477,1475,1052,-425
BANC,"11/3/2017 2 a.m. PDT",1425,1445,960,-465
BANC,"11/3/2017 3 a.m. PDT",1393,1402,975,-418
BANC,"11/3/2017 4 a.m. PDT",1379,1387,935,-444
BANC,"11/3/2017 5 a.m. PDT",1420,1409,973,-447
BANC,"11/3/2017 6 a.m. PDT",1524,1481,1087,-437
BANC,"11/3/2017 7 a.m. PDT",1707,1647,1282,-425
BANC,"11/3/2017 8 a.m. PDT",1831,1827,1383,-448
BANC,"11/3/2017 9 a.m. PDT",1851,1878,1297,-554
BANC,"11/3/2017 10 a.m. PDT",1884,1914,1297,-587
BANC,"11/3/2017 11 a.m. PDT",1896,1936,1310,-586
BANC,"11/3/2017 12 p.m. PDT",1873,1928,1300,-573
BANC,"11/3/2017 1 p.m. PDT",1878,1915,1298,-580
BANC,"11/3/2017 2 p.m. PDT",1875,1885,1299,-576
BANC,"11/3/2017 3 p.m. PDT",1869,1865,1294,-575
BANC,"11/3/2017 4 p.m. PDT",1850,1856,1328,-522
BANC,"11/3/2017 5 p.m. PDT",1867,1872,1378,-489
BANC,"11/3/2017 6 p.m. PDT",1919,1937,1495,-424
BANC,"11/3/2017 7 p.m. PDT",1963,2074,1586,-377
BANC,"11/3/2017 8 p.m. PDT",1945,2079,1617,-328
BANC,"11/3/2017 9 p.m. PDT",1892,2023,1682,-210
BANC,"11/3/2017 10 p.m. PDT",1809,1928,1418,-391
BANC,"11/3/2017 11 p.m. PDT",1699,1806,1059,-640
BANC,"11/4/2017 12 a.m. PDT",1583,1661,983,-600
BANC,"11/4/2017 1 a.m. PDT",1484,1507,917,-567
BANC,"11/4/2017 2 a.m. PDT",1418,1466,830,-588
BANC,"11/4/2017 3 a.m. PDT",1386,1428,812,-574
BANC,"11/4/2017 4 a.m. PDT",1362,1406,828,-534
BANC,"11/4/2017 5 a.m. PDT",1374,1410,827,-547
BANC,"11/4/2017 6 a.m. PDT",1411,1458,836,-575
BANC,"11/4/2017 7 a.m. PDT",1490,1537,913,-577
BANC,"11/4/2017 8 a.m. PDT",1575,1608,1037,-538
BANC,"11/4/2017 9 a.m. PDT",1672,1674,1071,-601
BANC,"11/4/2017 10 a.m. PDT",1742,1744,1159,-583
BANC,"11/4/2017 11 a.m. PDT",1790,1808,1174,-616
BANC,"11/4/2017 12 p.m. PDT",1793,1833,1128,-665
BANC,"11/4/2017 1 p.m. PDT",1785,1800,1135,-650
BANC,"11/4/2017 2 p.m. PDT",1748,1785,1103,-645
BANC,"11/4/2017 3 p.m. PDT",1713,1760,1098,-615
BANC,"11/4/2017 4 p.m. PDT",1692,1737,1091,-601
BANC,"11/4/2017 5 p.m. PDT",1721,1733,1166,-555
BANC,"11/4/2017 6 p.m. PDT",1753,1784,1368,-385
BANC,"11/4/2017 7 p.m. PDT",1866,1925,1483,-383
BANC,"11/4/2017 8 p.m. PDT",1855,1957,1554,-301
BANC,"11/4/2017 9 p.m. PDT",1824,1900,1473,-351
BANC,"11/4/2017 10 p.m. PDT",1760,1836,1362,-398
BANC,"11/4/2017 11 p.m. PDT",1667,1745,1202,-465
BANC,"11/5/2017 12 a.m. PDT",1552,1641,881,-671
BANC,"11/5/2017 1 a.m. PDT",1482,1475,864,-618
BANC,"11/5/2017 1 a.m. PST",1411,1423,823,-588
BANC,"11/5/2017 2 a.m. PST",1376,1410,802,-574
BANC,"11/5/2017 3 a.m. PST",1357,1385,851,-506
BANC,"11/5/2017 4 a.m. PST",1371,1377,898,-473
BANC,"11/5/2017 5 a.m. PST",1382,1411,928,-454
BANC,"11/5/2017 6 a.m. PST",1441,1466,949,-492
BANC,"11/5/2017 7 a.m. PST",1509,1547,999,-510
BANC,"11/5/2017 8 a.m. PST",1570,1603,1109,-461
BANC,"11/5/2017 9 a.m. PST",1632,1678,1150,-482
BANC,"11/5/2017 10 a.m. PST",1657,1716,1053,-604
BANC,"11/5/2017 11 a.m. PST",1642,1717,1006,-636
BANC,"11/5/2017 12 p.m. PST",1638,1714,1055,-583
BANC,"11/5/2017 1 p.m. PST",1617,1692,1052,-565
BANC,"11/5/2017 2 p.m. PST",1608,1669,1039,-569
BANC,"11/5/2017 3 p.m. PST",1622,1680,1075,-547
BANC,"11/5/2017 4 p.m. PST",1660,1705,1148,-512
BANC,"11/5/2017 5 p.m. PST",1737,1808,1347,-390
BANC,"11/5/2017 6 p.m. PST",1930,1980,1500,-430
BANC,"11/5/2017 7 p.m. PST",1955,1993,1493,-462
BANC,"11/5/2017 8 p.m. PST",1925,1964,1515,-410
BANC,"11/5/2017 9 p.m. PST",1879,1877,1453,-426
BANC,"11/5/2017 10 p.m. PST",1768,1776,1261,-507
BANC,"11/5/2017 11 p.m. PST",1649,1628,1088,-561
BANC,"11/6/2017 12 a.m. PST",1520,1499,1218,-302
BANC,"11/6/2017 1 a.m. PST",1453,1490,1350,-103
BANC,"11/6/2017 2 a.m. PST",1413,1438,1245,-168
BANC,"11/6/2017 3 a.m. PST",1404,1413,1314,-90
BANC,"11/6/2017 4 a.m. PST",1410,1416,1223,-187
BANC,"11/6/2017 5 a.m. PST",1478,1466,1251,-227
BANC,"11/6/2017 6 a.m. PST",1610,1592,1286,-324
BANC,"11/6/2017 7 a.m. PST",1821,1787,1353,-468
BANC,"11/6/2017 8 a.m. PST",1884,1854,1362,-522
BANC,"11/6/2017 9 a.m. PST",1876,1867,1302,-574
BANC,"11/6/2017 10 a.m. PST",1860,1879,1340,-520
BANC,"11/6/2017 11 a.m. PST",1834,1874,1216,-618
BANC,"11/6/2017 12 p.m. PST",1808,1868,1229,-579
BANC,"11/6/2017 1 p.m. PST",1830,1854,1371,-459
BANC,"11/6/2017 2 p.m. PST",1808,1850,1270,-538
BANC,"11/6/2017 3 p.m. PST",1813,1859,1253,-560
BANC,"11/6/2017 4 p.m. PST",1818,1863,1144,-674
BANC,"11/6/2017 5 p.m. PST",1892,1939,1181,-711
BANC,"11/6/2017 6 p.m. PST",2051,2106,1491,-560
BANC,"11/6/2017 7 p.m. PST",2062,2123,1745,-317
BANC,"11/6/2017 8 p.m. PST",2037,2097,1712,-325
BANC,"11/6/2017 9 p.m. PST",1967,2057,1499,-468
BANC,"11/6/2017 10 p.m. PST",1846,1939,1319,-527
BANC,"11/6/2017 11 p.m. PST",1706,1811,1166,-540
BANC,"11/7/2017 12 a.m. PST",1579,1667,1092,-487
BANC,"11/7/2017 1 a.m. PST",1504,1546,982,-522
BANC,"11/7/2017 2 a.m. PST",1470,1501,941,-529
BANC,"11/7/2017 3 a.m. PST",1448,1485,938,-510
BANC,"11/7/2017 4 a.m. PST",1463,1495,960,-503
BANC,"11/7/2017 5 a.m. PST",1521,1558,982,-539
BANC,"11/7/2017 6 a.m. PST",1670,1707,1017,-653
BANC,"11/7/2017 7 a.m. PST",1871,1922,1070,-801
BANC,"11/7/2017 8 a.m. PST",1924,1987,1148,-776
BANC,"11/7/2017 9 a.m. PST",1906,1967,1066,-840
BANC,"11/7/2017 10 a.m. PST",1862,1941,1129,-733
BANC,"11/7/2017 11 a.m. PST",1840,1915,1209,-631
BANC,"11/7/2017 12 p.m. PST",1826,1877,1164,-662
BANC,"11/7/2017 1 p.m. PST",1807,1856,1115,-692
BANC,"11/7/2017 2 p.m. PST",1803,1844,1233,-570
BANC,"11/7/2017 3 p.m. PST",1814,1832,1328,-486
BANC,"11/7/2017 4 p.m. PST",1805,1843,1168,-637
BANC,"11/7/2017 5 p.m. PST",1886,1915,1163,-723
BANC,"11/7/2017 6 p.m. PST",2042,2101,1320,-722
BANC,"11/7/2017 7 p.m. PST",2065,2128,1512,-553
BANC,"11/7/2017 8 p.m. PST",2030,2104,1518,-512
BANC,"11/7/2017 9 p.m. PST",1972,2050,1493,-479
BANC,"11/7/2017 10 p.m. PST",1867,1939,1252,-615
BANC,"11/7/2017 11 p.m. PST",1713,1787,1069,-644
BANC,"11/8/2017 12 a.m. PST",1592,1656,1030,-562
BANC,"11/8/2017 1 a.m. PST",1489,1499,948,-541
BANC,"11/8/2017 2 a.m. PST",1443,1448,906,-537
BANC,"11/8/2017 3 a.m. PST",1423,1428,901,-522
BANC,"11/8/2017 4 a.m. PST",1431,1436,898,-533
BANC,"11/8/2017 5 a.m. PST",1485,1492,919,-566
BANC,"11/8/2017 6 a.m. PST",1603,1626,987,-616
BANC,"11/8/2017 7 a.m. PST",1808,1831,1076,-732
BANC,"11/8/2017 8 a.m. PST",1878,1930,1005,-873
BANC,"11/8/2017 9 a.m. PST",1882,1929,1112,-770
BANC,"11/8/2017 10 a.m. PST",1902,1923,1156,-746
BANC,"11/8/2017 11 a.m. PST",1911,1921,1237,-674
BANC,"11/8/2017 12 p.m. PST",1918,1897,1260,-658
BANC,"11/8/2017 1 p.m. PST",1912,1874,1194,-718
BANC,"11/8/2017 2 p.m. PST",1874,1859,1136,-738
BANC,"11/8/2017 3 p.m. PST",1887,1851,1135,-752
BANC,"11/8/2017 4 p.m. PST",1883,1857,1086,-797
BANC,"11/8/2017 5 p.m. PST",1943,1912,1350,-593
BANC,"11/8/2017 6 p.m. PST",2071,2081,1538,-533
BANC,"11/8/2017 7 p.m. PST",2074,2096,1539,-535
BANC,"11/8/2017 8 p.m. PST",2024,2065,1588,-436
BANC,"11/8/2017 9 p.m. PST",1960,2008,1362,-598
BANC,"11/8/2017 10 p.m. PST",1841,1895,1216,-625
BANC,"11/8/2017 11 p.m. PST",1697,1747,1039,-658
BANC,"11/9/2017 12 a.m. PST",1559,1612,1008,-551
BANC,"11/9/2017 1 a.m. PST",1482,1487,869,-613
BANC,"11/9/2017 2 a.m. PST",1432,1432,841,-591
BANC,"11/9/2017 3 a.m. PST",1394,1406,810,-584
BANC,"11/9/2017 4 a.m. PST",1404,1406,820,-584
BANC,"11/9/2017 5 a.m. PST",1436,1449,871,-565
BANC,"11/9/2017 6 a.m. PST",1553,1567,977,-576
BANC,"11/9/2017 7 a.m. PST",1726,1760,1262,-464
BANC,"11/9/2017 8 a.m. PST",1790,1824,947,-843
BANC,"11/9/2017 9 a.m. PST",1820,1837,880,-940
BANC,"11/9/2017 10 a.m. PST",1852,1846,891,-961
BANC,"11/9/2017 11 a.m. PST",1853,1855,917,-936
BANC,"11/9/2017 12 p.m. PST",1876,1845,1090,-786
BANC,"11/9/2017 1 p.m. PST",1881,1841,1089,-792
BANC,"11/9/2017 2 p.m. PST",1882,1836,1071,-811
BANC,"11/9/2017 3 p.m. PST",1870,1832,1057,-813
BANC,"11/9/2017 4 p.m. PST",1848,1836,1086,-762
BANC,"11/9/2017 5 p.m. PST",1875,1902,1008,-867
BANC,"11/9/2017 6 p.m. PST",2021,2024,1359,-662
BANC,"11/9/2017 7 p.m. PST",2018,2053,1418,-600
BANC,"11/9/2017 8 p.m. PST",1964,2031,1404,-560
BANC,"11/9/2017 9 p.m. PST",1913,1978,1251,-662
BANC,"11/9/2017 10 p.m. PST",1810,1867,1118,-692
BANC,"11/9/2017 11 p.m. PST",1686,1723,1004,-682
BANC,"11/10/2017 12 a.m. PST",1557,1595,937,-620
BANC,"11/10/2017 1 a.m. PST",1467,1480,817,-650
BANC,"11/10/2017 2 a.m. PST",1414,1424,809,-605
BANC,"11/10/2017 3 a.m. PST",1387,1397,754,-633
BANC,"11/10/2017 4 a.m. PST",1378,1402,752,-626
BANC,"11/10/2017 5 a.m. PST",1414,1443,793,-621
BANC,"11/10/2017 6 a.m. PST",1513,1552,888,-625
BANC,"11/10/2017 7 a.m. PST",1633,1674,1075,-558
BANC,"11/10/2017 8 a.m. PST",1716,1734,1099,-617
BANC,"11/10/2017 9 a.m. PST",1770,1775,954,-816
BANC,"11/10/2017 10 a.m. PST",1836,1808,923,-913
BANC,"11/10/2017 11 a.m. PST",1847,1827,985,-862
BANC,"11/10/2017 12 p.m. PST",1845,1837,1017,-828
BANC,"11/10/2017 1 p.m. PST",1848,1842,1021,-827
BANC,"11/10/2017 2 p.m. PST",1856,1837,1029,-827
BANC,"11/10/2017 3 p.m. PST",1832,1846,1010,-822
BANC,"11/10/2017 4 p.m. PST",1812,1840,985,-827
BANC,"11/10/2017 5 p.m. PST",1842,1899,955,-887
BANC,"11/10/2017 6 p.m. PST",1981,2054,1412,-569
BANC,"11/10/2017 7 p.m. PST",1960,2044,1420,-540
BANC,"11/10/2017 8 p.m. PST",1918,2001,1246,-672
BANC,"11/10/2017 9 p.m. PST",1853,1937,1151,-702
BANC,"11/10/2017 10 p.m. PST",1775,1827,1015,-760
BANC,"11/10/2017 11 p.m. PST",1661,1679,941,-720
BANC,"11/11/2017 12 a.m. PST",1561,1548,891,-670
BANC,"11/11/2017 1 a.m. PST",1461,1499,847,-614
BANC,"11/11/2017 2 a.m. PST",1416,1442,790,-626
BANC,"11/11/2017 3 a.m. PST",1388,1408,765,-623
BANC,"11/11/2017 4 a.m. PST",1372,1398,755,-617
BANC,"11/11/2017 5 a.m. PST",1384,1419,1105,-279
BANC,"11/11/2017 6 a.m. PST",1438,1474,1145,-293
BANC,"11/11/2017 7 a.m. PST",1514,1547,1154,-360
BANC,"11/11/2017 8 a.m. PST",1560,1593,1092,-468
BANC,"11/11/2017 9 a.m. PST",1653,1675,1130,-523
BANC,"11/11/2017 10 a.m. PST",1686,1713,1148,-538
BANC,"11/11/2017 11 a.m. PST",1679,1723,1101,-578
BANC,"11/11/2017 12 p.m. PST",1648,1707,1063,-585
BANC,"11/11/2017 1 p.m. PST",1637,1685,1081,-556
BANC,"11/11/2017 2 p.m. PST",1614,1659,1028,-586
BANC,"11/11/2017 3 p.m. PST",1620,1649,1040,-580
BANC,"11/11/2017 4 p.m. PST",1639,1661,1126,-513
BANC,"11/11/2017 5 p.m. PST",1706,1735,1171,-535
BANC,"11/11/2017 6 p.m. PST",1849,1933,1455,-394
BANC,"11/11/2017 7 p.m. PST",1865,1933,1537,-328
BANC,"11/11/2017 8 p.m. PST",1847,1911,1704,-143
BANC,"11/11/2017 9 p.m. PST",1805,1871,1595,-210
BANC,"11/11/2017 10 p.m. PST",1732,1796,1070,-662
BANC,"11/11/2017 11 p.m. PST",1630,1694,1100,-530
BANC,"11/12/2017 12 a.m. PST",1536,1577,998,-538
BANC,"11/12/2017 1 a.m. PST",1454,1459,823,-631
BANC,"11/12/2017 2 a.m. PST",1402,1401,798,-604
BANC,"11/12/2017 3 a.m. PST",1369,1368,793,-576
BANC,"11/12/2017 4 a.m. PST",1363,1356,818,-545
BANC,"11/12/2017 5 a.m. PST",1368,1369,743,-625
BANC,"11/12/2017 6 a.m. PST",1407,1420,834,-573
BANC,"11/12/2017 7 a.m. PST",1478,1489,900,-578
BANC,"11/12/2017 8 a.m. PST",1515,1548,882,-633
BANC,"11/12/2017 9 a.m. PST",1580,1630,922,-658
BANC,"11/12/2017 10 a.m. PST",1601,1677,1034,-567
BANC,"11/12/2017 11 a.m. PST",1629,1691,969,-660
BANC,"11/12/2017 12 p.m. PST",1631,1679,1029,-602
BANC,"11/12/2017 1 p.m. PST",1628,1662,1032,-596
BANC,"11/12/2017 2 p.m. PST",1626,1642,1033,-593
BANC,"11/12/2017 3 p.m. PST",1619,1631,1030,-589
BANC,"11/12/2017 4 p.m. PST",1667,1657,1089,-578
BANC,"11/12/2017 5 p.m. PST",1744,1757,1117,-627
BANC,"11/12/2017 6 p.m. PST",1932,1950,1451,-481
BANC,"11/12/2017 7 p.m. PST",1952,1968,1511,-441
BANC,"11/12/2017 8 p.m. PST",1917,1946,1600,-317
BANC,"11/12/2017 9 p.m. PST",1860,1899,1503,-357
BANC,"11/12/2017 10 p.m. PST",1767,1799,1192,-575
BANC,"11/12/2017 11 p.m. PST",1632,1644,1003,-629
BANC,"11/13/2017 12 a.m. PST",1510,1517,863,-647
BANC,"11/13/2017 1 a.m. PST",1437,1439,778,-659
BANC,"11/13/2017 2 a.m. PST",1375,1388,690,-685
BANC,"11/13/2017 3 a.m. PST",1362,1366,682,-680
BANC,"11/13/2017 4 a.m. PST",1364,1366,681,-683
BANC,"11/13/2017 5 a.m. PST",1425,1414,756,-669
BANC,"11/13/2017 6 a.m. PST",1548,1532,845,-703
BANC,"11/13/2017 7 a.m. PST",1747,1719,1060,-687
BANC,"11/13/2017 8 a.m. PST",1823,1793,986,-837
BANC,"11/13/2017 9 a.m. PST",1842,1811,1016,-826
BANC,"11/13/2017 10 a.m. PST",1846,1820,992,-854
BANC,"11/13/2017 11 a.m. PST",1855,1837,885,-970
BANC,"11/13/2017 12 p.m. PST",1838,1836,854,-984
BANC,"11/13/2017 1 p.m. PST",1844,1835,951,-893
BANC,"11/13/2017 2 p.m. PST",1858,1824,993,-865
BANC,"11/13/2017 3 p.m. PST",1856,1824,984,-872
BANC,"11/13/2017 4 p.m. PST",1873,1836,1072,-801
BANC,"11/13/2017 5 p.m. PST",1949,1884,1163,-786
BANC,"11/13/2017 6 p.m. PST",2067,2032,1534,-533
BANC,"11/13/2017 7 p.m. PST",2059,2048,1568,-491
BANC,"11/13/2017 8 p.m. PST",1991,2011,1320,-671
BANC,"11/13/2017 9 p.m. PST",1937,1958,1178,-759
BANC,"11/13/2017 10 p.m. PST",1811,1841,1012,-799
BANC,"11/13/2017 11 p.m. PST",1664,1683,951,-713
BANC,"11/14/2017 12 a.m. PST",1533,1532,813,-720
BANC,"11/14/2017 1 a.m. PST",1447,1490,733,-714
BANC,"11/14/2017 2 a.m. PST",1387,1443,681,-706
BANC,"11/14/2017 3 a.m. PST",1362,1427,692,-670
BANC,"11/14/2017 4 a.m. PST",1370,1430,684,-686
BANC,"11/14/2017 5 a.m. PST",1410,1484,774,-636
BANC,"11/14/2017 6 a.m. PST",1535,1610,820,-715
BANC,"11/14/2017 7 a.m. PST",1721,1808,866,-855
BANC,"11/14/2017 8 a.m. PST",1786,1881,923,-863
BANC,"11/14/2017 9 a.m. PST",1784,1869,871,-913
BANC,"11/14/2017 10 a.m. PST",1783,1878,871,-912
BANC,"11/14/2017 11 a.m. PST",1781,1876,862,-919
BANC,"11/14/2017 12 p.m. PST",1767,1869,855,-912
BANC,"11/14/2017 1 p.m. PST",1768,1872,840,-928
BANC,"11/14/2017 2 p.m. PST",1772,1831,845,-927
BANC,"11/14/2017 3 p.m. PST",1788,1843,881,-907
BANC,"11/14/2017 4 p.m. PST",1803,1845,915,-888
BANC,"11/14/2017 5 p.m. PST",1851,1898,1111,-740
BANC,"11/14/2017 6 p.m. PST",2021,2049,1388,-633
BANC,"11/14/2017 7 p.m. PST",2026,2060,1402,-624
BANC,"11/14/2017 8 p.m. PST",1991,2013,1347,-644
BANC,"11/14/2017 9 p.m. PST",1932,1947,1112,-820
BANC,"11/14/2017 10 p.m. PST",1828,1838,900,-928
BANC,"11/14/2017 11 p.m. PST",1675,1684,862,-813
BANC,"11/15/2017 12 a.m. PST",1546,1553,784,-762
BANC,"11/15/2017 1 a.m. PST",1463,1526,775,-688
BANC,"11/15/2017 2 a.m. PST",1414,1469,676,-738
BANC,"11/15/2017 3 a.m. PST",1390,1442,652,-738
BANC,"11/15/2017 4 a.m. PST",1393,1448,650,-743
BANC,"11/15/2017 5 a.m. PST",1436,1495,688,-748
BANC,"11/15/2017 6 a.m. PST",1560,1626,756,-804
BANC,"11/15/2017 7 a.m. PST",1752,1829,864,-888
BANC,"11/15/2017 8 a.m. PST",1856,1903,969,-887
BANC,"11/15/2017 9 a.m. PST",1890,1910,959,-931
BANC,"11/15/2017 10 a.m. PST",1930,1921,1017,-913
BANC,"11/15/2017 11 a.m. PST",1941,1925,1016,-925
BANC,"11/15/2017 12 p.m. PST",1925,1909,1005,-920
BANC,"11/15/2017 1 p.m. PST",1912,1900,981,-931
BANC,"11/15/2017 2 p.m. PST",1902,1883,977,-925
BANC,"11/15/2017 3 p.m. PST",1892,1875,971,-921
BANC,"11/15/2017 4 p.m. PST",1901,1879,1053,-848
BANC,"11/15/2017 5 p.m. PST",1966,1960,1114,-852
BANC,"11/15/2017 6 p.m. PST",2089,2127,1339,-750
BANC,"11/15/2017 7 p.m. PST",2090,2130,1346,-744
BANC,"11/15/2017 8 p.m. PST",2038,2102,1275,-763
BANC,"11/15/2017 9 p.m. PST",1981,2046,998,-983
BANC,"11/15/2017 10 p.m. PST",1868,1931,925,-943
BANC,"11/15/2017 11 p.m. PST",1718,1776,814,-904
BANC,"11/16/2017 12 a.m. PST",1576,1649,756,-820
BANC,"11/16/2017 1 a.m. PST",1471,1489,758,-713
BANC,"11/16/2017 2 a.m. PST",1427,1431,729,-698
BANC,"11/16/2017 3 a.m. PST",1388,1407,694,-694
BANC,"11/16/2017 4 a.m. PST",1395,1411,712,-683
BANC,"11/16/2017 5 a.m. PST",1435,1454,760,-675
BANC,"11/16/2017 6 a.m. PST",1548,1578,862,-686
BANC,"11/16/2017 7 a.m. PST",1739,1789,964,-775
BANC,"11/16/2017 8 a.m. PST",1843,1871,974,-869
BANC,"11/16/2017 9 a.m. PST",1868,1879,985,-883
BANC,"11/16/2017 10 a.m. PST",1906,1883,1017,-889
BANC,"11/16/2017 11 a.m. PST",1929,1884,1058,-871
BANC,"11/16/2017 12 p.m. PST",1937,1881,1105,-832
BANC,"11/16/2017 1 p.m. PST",1924,1879,1125,-799
BANC,"11/16/2017 2 p.m. PST",1923,1861,1091,-832
BANC,"11/16/2017 3 p.m. PST",1911,1854,1149,-762
BANC,"11/16/2017 4 p.m. PST",1902,1850,1133,-769
BANC,"11/16/2017 5 p.m. PST",1968,1931,1276,-692
BANC,"11/16/2017 6 p.m. PST",2070,2096,1497,-573
BANC,"11/16/2017 7 p.m. PST",2066,2128,1540,-526
BANC,"11/16/2017 8 p.m. PST",2019,2083,1332,-687
BANC,"11/16/2017 9 p.m. PST",1956,2019,1135,-821
BANC,"11/16/2017 10 p.m. PST",1852,1903,945,-907
BANC,"11/16/2017 11 p.m. PST",1696,1758,947,-749
BANC,"11/17/2017 12 a.m. PST",1569,1620,874,-695
BANC,"11/17/2017 1 a.m. PST",1514,1550,558,-956
BANC,"11/17/2017 2 a.m. PST",1473,1492,449,-1024
BANC,"11/17/2017 3 a.m. PST",1439,1467,404,-1035
BANC,"11/17/2017 4 a.m. PST",1438,1466,390,-1048
BANC,"11/17/2017 5 a.m. PST",1496,1521,428,-1068
BANC,"11/17/2017 6 a.m. PST",1612,1639,561,-1051
BANC,"11/17/2017 7 a.m. PST",1804,1832,846,-958
BANC,"11/17/2017 8 a.m. PST",1873,1901,692,-1181
BANC,"11/17/2017 9 a.m. PST",1880,1923,653,-1227
BANC,"11/17/2017 10 a.m. PST",1856,1932,605,-1251
BANC,"11/17/2017 11 a.m. PST",1843,1917,620,-1223
BANC,"11/17/2017 12 p.m. PST",1826,1909,656,-1170
BANC,"11/17/2017 1 p.m. PST",1818,1887,669,-1149
BANC,"11/17/2017 2 p.m. PST",1799,1864,674,-1125
BANC,"11/17/2017 3 p.m. PST",1802,1857,677,-1125
BANC,"11/17/2017 4 p.m. PST",1820,1876,658,-1162
BANC,"11/17/2017 5 p.m. PST",1890,1947,915,-975
BANC,"11/17/2017 6 p.m. PST",2053,2124,1034,-1019
BANC,"11/17/2017 7 p.m. PST",2075,2139,1026,-1049
BANC,"11/17/2017 8 p.m. PST",2052,2111,724,-1328
BANC,"11/17/2017 9 p.m. PST",2005,2053,563,-1442
BANC,"11/17/2017 10 p.m. PST",1922,1942,646,-1276
BANC,"11/17/2017 11 p.m. PST",1820,1806,590,-1230
BANC,"11/18/2017 12 a.m. PST",1707,1677,563,-1144
BANC,"11/18/2017 1 a.m. PST",1607,1630,498,-1109
BANC,"11/18/2017 2 a.m. PST",1553,1580,461,-1092
BANC,"11/18/2017 3 a.m. PST",1512,1547,424,-1088
BANC,"11/18/2017 4 a.m. PST",1510,1540,409,-1101
BANC,"11/18/2017 5 a.m. PST",1536,1556,430,-1106
BANC,"11/18/2017 6 a.m. PST",1593,1635,507,-1086
BANC,"11/18/2017 7 a.m. PST",1703,1705,598,-1105
BANC,"11/18/2017 8 a.m. PST",1750,1767,679,-1071
BANC,"11/18/2017 9 a.m. PST",1793,1834,690,-1103
BANC,"11/18/2017 10 a.m. PST",1789,1839,675,-1114
BANC,"11/18/2017 11 a.m. PST",1763,1819,647,-1116
BANC,"11/18/2017 12 p.m. PST",1735,1787,628,-1107
BANC,"11/18/2017 1 p.m. PST",1708,1752,701,-1007
BANC,"11/18/2017 2 p.m. PST",1680,1732,694,-986
BANC,"11/18/2017 3 p.m. PST",1689,1717,700,-989
BANC,"11/18/2017 4 p.m. PST",1725,1733,744,-981
BANC,"11/18/2017 5 p.m. PST",1822,1808,1015,-807
BANC,"11/18/2017 6 p.m. PST",2000,1990,1123,-877
BANC,"11/18/2017 7 p.m. PST",2014,1999,1081,-933
BANC,"11/18/2017 8 p.m. PST",2002,1975,982,-1020
BANC,"11/18/2017 9 p.m. PST",1956,1933,916,-1040
BANC,"11/18/2017 10 p.m. PST",1885,1875,814,-1071
BANC,"11/18/2017 11 p.m. PST",1783,1761,750,-1033
BANC,"11/19/2017 12 a.m. PST",1668,1648,724,-944
BANC,"11/19/2017 1 a.m. PST",1607,1589,747,-860
BANC,"11/19/2017 2 a.m. PST",1554,1519,715,-839
BANC,"11/19/2017 3 a.m. PST",1527,1485,705,-822
BANC,"11/19/2017 4 a.m. PST",1521,1479,710,-811
BANC,"11/19/2017 5 a.m. PST",1536,1493,688,-848
BANC,"11/19/2017 6 a.m. PST",1589,1547,743,-846
BANC,"11/19/2017 7 a.m. PST",1681,1630,786,-895
BANC,"11/19/2017 8 a.m. PST",1715,1679,739,-976
BANC,"11/19/2017 9 a.m. PST",1751,1739,755,-996
BANC,"11/19/2017 10 a.m. PST",1749,1769,741,-1008
BANC,"11/19/2017 11 a.m. PST",1728,1792,726,-1002
BANC,"11/19/2017 12 p.m. PST",1717,1782,699,-1018
BANC,"11/19/2017 1 p.m. PST",1702,1763,729,-973
BANC,"11/19/2017 2 p.m. PST",1672,1742,699,-973
BANC,"11/19/2017 3 p.m. PST",1698,1732,723,-975
BANC,"11/19/2017 4 p.m. PST",1748,1748,810,-938
BANC,"11/19/2017 5 p.m. PST",1889,1843,881,-1008
BANC,"11/19/2017 6 p.m. PST",2081,2052,928,-1153
BANC,"11/19/2017 7 p.m. PST",2089,2080,898,-1191
BANC,"11/19/2017 8 p.m. PST",2066,2054,856,-1210
BANC,"11/19/2017 9 p.m. PST",1997,2004,888,-1109
BANC,"11/19/2017 10 p.m. PST",1917,1899,851,-1066
BANC,"11/19/2017 11 p.m. PST",1758,1753,803,-955
BANC,"11/20/2017 12 a.m. PST",1627,1616,754,-873
BANC,"11/20/2017 1 a.m. PST",1554,1539,667,-887
BANC,"11/20/2017 2 a.m. PST",1493,1487,588,-905
BANC,"11/20/2017 3 a.m. PST",1462,1467,568,-894
BANC,"11/20/2017 4 a.m. PST",1474,1466,604,-870
BANC,"11/20/2017 5 a.m. PST",1524,1520,645,-879
BANC,"11/20/2017 6 a.m. PST",1645,1646,766,-879
BANC,"11/20/2017 7 a.m. PST",1821,1866,720,-1101
BANC,"11/20/2017 8 a.m. PST",1890,1929,732,-1158
BANC,"11/20/2017 9 a.m. PST",1941,1937,747,-1194
BANC,"11/20/2017 10 a.m. PST",1970,1941,798,-1172
BANC,"11/20/2017 11 a.m. PST",1983,1954,815,-1168
BANC,"11/20/2017 12 p.m. PST",2016,1950,828,-1188
BANC,"11/20/2017 1 p.m. PST",2015,1940,821,-1194
BANC,"11/20/2017 2 p.m. PST",2013,1923,812,-1201
BANC,"11/20/2017 3 p.m. PST",1999,1916,804,-1195
BANC,"11/20/2017 4 p.m. PST",2016,1919,820,-1196
BANC,"11/20/2017 5 p.m. PST",2099,2006,954,-1145
BANC,"11/20/2017 6 p.m. PST",2214,2136,1170,-1044
BANC,"11/20/2017 7 p.m. PST",2196,2137,917,-1279
BANC,"11/20/2017 8 p.m. PST",2149,2094,852,-1297
BANC,"11/20/2017 9 p.m. PST",2082,2031,827,-1255
BANC,"11/20/2017 10 p.m. PST",1967,1919,811,-1156
BANC,"11/20/2017 11 p.m. PST",1836,1763,826,-1010
BANC,"11/21/2017 12 a.m. PST",1687,1626,742,-945
BANC,"11/21/2017 1 a.m. PST",1575,1548,686,-889
BANC,"11/21/2017 2 a.m. PST",1517,1498,642,-875
BANC,"11/21/2017 3 a.m. PST",1478,1474,610,-868
BANC,"11/21/2017 4 a.m. PST",1479,1474,603,-876
BANC,"11/21/2017 5 a.m. PST",1517,1526,658,-859
BANC,"11/21/2017 6 a.m. PST",1638,1650,747,-891
BANC,"11/21/2017 7 a.m. PST",1802,1847,835,-967
BANC,"11/21/2017 8 a.m. PST",1878,1906,862,-1016
BANC,"11/21/2017 9 a.m. PST",1929,1890,864,-1065
BANC,"11/21/2017 10 a.m. PST",1953,1886,889,-1064
BANC,"11/21/2017 11 a.m. PST",1943,1886,856,-1087
BANC,"11/21/2017 12 p.m. PST",1940,1877,867,-1073
BANC,"11/21/2017 1 p.m. PST",1906,1867,791,-1115
BANC,"11/21/2017 2 p.m. PST",1898,1867,798,-1100
BANC,"11/21/2017 3 p.m. PST",1915,1881,827,-1088
BANC,"11/21/2017 4 p.m. PST",1872,1908,780,-1092
BANC,"11/21/2017 5 p.m. PST",1845,1992,881,-964
BANC,"11/21/2017 6 p.m. PST",2028,2166,1104,-924
BANC,"11/21/2017 7 p.m. PST",2010,2190,1046,-964
BANC,"11/21/2017 8 p.m. PST",2033,2153,864,-1169
BANC,"11/21/2017 9 p.m. PST",2057,2087,766,-1291
BANC,"11/21/2017 10 p.m. PST",1972,1969,777,-1195
BANC,"11/21/2017 11 p.m. PST",1822,1814,840,-982
BANC,"11/22/2017 12 a.m. PST",1709,1664,808,-901
BANC,"11/22/2017 1 a.m. PST",1583,1549,744,-839
BANC,"11/22/2017 2 a.m. PST",1531,1497,684,-847
BANC,"11/22/2017 3 a.m. PST",1495,1470,668,-827
BANC,"11/22/2017 4 a.m. PST",1491,1472,666,-825
BANC,"11/22/2017 5 a.m. PST",1533,1521,695,-838
BANC,"11/22/2017 6 a.m. PST",1653,1649,850,-803
BANC,"11/22/2017 7 a.m. PST",1811,1856,890,-921
BANC,"11/22/2017 8 a.m. PST",1872,1914,905,-967
BANC,"11/22/2017 9 a.m. PST",1904,1912,912,-992
BANC,"11/22/2017 10 a.m. PST",1911,1916,857,-1054
BANC,"11/22/2017 11 a.m. PST",1893,1924,861,-1032
BANC,"11/22/2017 12 p.m. PST",1914,1945,911,-1003
BANC,"11/22/2017 1 p.m. PST",1926,1935,921,-1005
BANC,"11/22/2017 2 p.m. PST",1931,1941,911,-1020
BANC,"11/22/2017 3 p.m. PST",1944,1951,938,-1006
BANC,"11/22/2017 4 p.m. PST",1954,1955,889,-1065
BANC,"11/22/2017 5 p.m. PST",2014,2038,1146,-868
BANC,"11/22/2017 6 p.m. PST",2145,2197,1170,-975
BANC,"11/22/2017 7 p.m. PST",2125,2209,1153,-972
BANC,"11/22/2017 8 p.m. PST",2086,2159,1039,-1047
BANC,"11/22/2017 9 p.m. PST",2027,2082,909,-1118
BANC,"11/22/2017 10 p.m. PST",1943,1959,861,-1082
BANC,"11/22/2017 11 p.m. PST",1810,1794,867,-943
BANC,"11/23/2017 12 a.m. PST",1685,1652,801,-884
BANC,"11/23/2017 1 a.m. PST",1588,1604,774,-814
BANC,"11/23/2017 2 a.m. PST",1505,1540,763,-742
BANC,"11/23/2017 3 a.m. PST",1464,1503,729,-735
BANC,"11/23/2017 4 a.m. PST",1442,1488,711,-731
BANC,"11/23/2017 5 a.m. PST",1449,1513,706,-743
BANC,"11/23/2017 6 a.m. PST",1503,1583,736,-767
BANC,"11/23/2017 7 a.m. PST",1586,1690,756,-830
BANC,"11/23/2017 8 a.m. PST",1615,1746,735,-880
BANC,"11/23/2017 9 a.m. PST",1686,1806,756,-930
BANC,"11/23/2017 10 a.m. PST",1764,1835,854,-910
BANC,"11/23/2017 11 a.m. PST",1839,1861,938,-901
BANC,"11/23/2017 12 p.m. PST",1897,1871,967,-930
BANC,"11/23/2017 1 p.m. PST",1899,1839,974,-925
BANC,"11/23/2017 2 p.m. PST",1881,1798,1018,-863
BANC,"11/23/2017 3 p.m. PST",1837,1771,924,-913
BANC,"11/23/2017 4 p.m. PST",1793,1736,872,-921
BANC,"11/23/2017 5 p.m. PST",1794,1770,953,-841
BANC,"11/23/2017 6 p.m. PST",1835,1873,926,-909
BANC,"11/23/2017 7 p.m. PST",1800,1863,911,-889
BANC,"11/23/2017 8 p.m. PST",1786,1857,847,-939
BANC,"11/23/2017 9 p.m. PST",1757,1846,851,-906
BANC,"11/23/2017 10 p.m. PST",1732,1804,904,-828
BANC,"11/23/2017 11 p.m. PST",1663,1726,742,-921
BANC,"11/24/2017 12 a.m. PST",1585,1624,669,-916
BANC,"11/24/2017 1 a.m. PST",1515,1553,722,-793
BANC,"11/24/2017 2 a.m. PST",1469,1501,714,-755
BANC,"11/24/2017 3 a.m. PST",1426,1476,699,-727
BANC,"11/24/2017 4 a.m. PST",1418,1474,691,-727
BANC,"11/24/2017 5 a.m. PST",1454,1503,706,-748
BANC,"11/24/2017 6 a.m. PST",1505,1576,727,-778
BANC,"11/24/2017 7 a.m. PST",1579,1681,785,-794
BANC,"11/24/2017 8 a.m. PST",1584,1705,737,-847
BANC,"11/24/2017 9 a.m. PST",1624,1750,664,-960
BANC,"11/24/2017 10 a.m. PST",1674,1771,749,-925
BANC,"11/24/2017 11 a.m. PST",1713,1803,733,-980
BANC,"11/24/2017 12 p.m. PST",1736,1805,822,-914
BANC,"11/24/2017 1 p.m. PST",1724,1799,851,-873
BANC,"11/24/2017 2 p.m. PST",1742,1789,873,-869
BANC,"11/24/2017 3 p.m. PST",1757,1799,879,-878
BANC,"11/24/2017 4 p.m. PST",1787,1814,862,-925
BANC,"11/24/2017 5 p.m. PST",1877,1915,1010,-867
BANC,"11/24/2017 6 p.m. PST",2006,2062,1098,-908
BANC,"11/24/2017 7 p.m. PST",1990,2063,1163,-827
BANC,"11/24/2017 8 p.m. PST",1948,2033,906,-1042
BANC,"11/24/2017 9 p.m. PST",1909,1982,899,-1010
BANC,"11/24/2017 10 p.m. PST",1833,1903,913,-920
BANC,"11/24/2017 11 p.m. PST",1745,1794,864,-881
BANC,"11/25/2017 12 a.m. PST",1622,1679,856,-766
BANC,"11/25/2017 1 a.m. PST",1536,1539,925,-611
BANC,"11/25/2017 2 a.m. PST",1461,1491,979,-482
BANC,"11/25/2017 3 a.m. PST",1429,1462,951,-478
BANC,"11/25/2017 4 a.m. PST",1414,1445,1017,-397
BANC,"11/25/2017 5 a.m. PST",1418,1464,1052,-366
BANC,"11/25/2017 6 a.m. PST",1464,1522,926,-538
BANC,"11/25/2017 7 a.m. PST",1532,1597,880,-652
BANC,"11/25/2017 8 a.m. PST",1551,1645,844,-707
BANC,"11/25/2017 9 a.m. PST",1625,1721,839,-786
BANC,"11/25/2017 10 a.m. PST",1684,1761,872,-812
BANC,"11/25/2017 11 a.m. PST",1739,1768,906,-833
BANC,"11/25/2017 12 p.m. PST",1746,1771,895,-851
BANC,"11/25/2017 1 p.m. PST",1727,1753,921,-806
BANC,"11/25/2017 2 p.m. PST",1745,1725,912,-833
BANC,"11/25/2017 3 p.m. PST",1763,1715,899,-864
BANC,"11/25/2017 4 p.m. PST",1790,1737,922,-868
BANC,"11/25/2017 5 p.m. PST",1871,1820,1033,-838
BANC,"11/25/2017 6 p.m. PST",2008,2026,1078,-930
BANC,"11/25/2017 7 p.m. PST",2006,2043,1085,-921
BANC,"11/25/2017 8 p.m. PST",1976,2028,972,-1004
BANC,"11/25/2017 9 p.m. PST",1935,1989,894,-1041
BANC,"11/25/2017 10 p.m. PST",1860,1913,839,-1021
BANC,"11/25/2017 11 p.m. PST",1744,1799,986,-758
BANC,"11/26/2017 12 a.m. PST",1629,1673,909,-720
BANC,"11/26/2017 1 a.m. PST",1541,1566,903,-638
BANC,"11/26/2017 2 a.m. PST",1474,1510,976,-498
BANC,"11/26/2017 3 a.m. PST",1440,1471,913,-527
BANC,"11/26/2017 4 a.m. PST",1415,1455,897,-518
BANC,"11/26/2017 5 a.m. PST",1430,1461,915,-515
BANC,"11/26/2017 6 a.m. PST",1456,1506,982,-474
BANC,"11/26/2017 7 a.m. PST",1521,1570,872,-649
BANC,"11/26/2017 8 a.m. PST",1559,1630,858,-701
BANC,"11/26/2017 9 a.m. PST",1651,1705,794,-857
BANC,"11/26/2017 10 a.m. PST",1728,1750,813,-915
BANC,"11/26/2017 11 a.m. PST",1814,1792,863,-951
BANC,"11/26/2017 12 p.m. PST",1866,1820,926,-940
BANC,"11/26/2017 1 p.m. PST",1906,1826,946,-960
BANC,"11/26/2017 2 p.m. PST",1895,1815,912,-983
BANC,"11/26/2017 3 p.m. PST",1903,1809,875,-1028
BANC,"11/26/2017 4 p.m. PST",1930,1840,895,-1035
BANC,"11/26/2017 5 p.m. PST",2028,1946,989,-1039
BANC,"11/26/2017 6 p.m. PST",2124,2112,1066,-1058
BANC,"11/26/2017 7 p.m. PST",2111,2128,1112,-999
BANC,"11/26/2017 8 p.m. PST",2093,2107,1136,-957
BANC,"11/26/2017 9 p.m. PST",2013,2047,1151,-862
BANC,"11/26/2017 10 p.m. PST",1919,1950,1062,-857
BANC,"11/26/2017 11 p.m. PST",1771,1807,1073,-698
BANC,"11/27/2017 12 a.m. PST",1630,1667,1059,-571
BANC,"11/27/2017 1 a.m. PST",1540,1555,993,-547
BANC,"11/27/2017 2 a.m. PST",1479,1503,986,-493
BANC,"11/27/2017 3 a.m. PST",1453,1474,980,-473
BANC,"11/27/2017 4 a.m. PST",1461,1477,997,-464
BANC,"11/27/2017 5 a.m. PST",1511,1527,1004,-507
BANC,"11/27/2017 6 a.m. PST",1645,1658,1170,-475
BANC,"11/27/2017 7 a.m. PST",1851,1868,1158,-693
BANC,"11/27/2017 8 a.m. PST",1937,1975,1197,-740
BANC,"11/27/2017 9 a.m. PST",1934,1977,1193,-741
BANC,"11/27/2017 10 a.m. PST",1915,1983,1186,-729
BANC,"11/27/2017 11 a.m. PST",1899,1980,1115,-784
BANC,"11/27/2017 12 p.m. PST",1893,1977,1055,-838
BANC,"11/27/2017 1 p.m. PST",1867,1978,976,-891
BANC,"11/27/2017 2 p.m. PST",1872,1948,925,-947
BANC,"11/27/2017 3 p.m. PST",1865,1932,918,-947
BANC,"11/27/2017 4 p.m. PST",1896,1944,1065,-831
BANC,"11/27/2017 5 p.m. PST",2002,2041,1219,-783
BANC,"11/27/2017 6 p.m. PST",2186,2248,1342,-844
BANC,"11/27/2017 7 p.m. PST",2218,2266,1303,-915
BANC,"11/27/2017 8 p.m. PST",2190,2235,1198,-992
BANC,"11/27/2017 9 p.m. PST",2134,2178,1201,-933
BANC,"11/27/2017 10 p.m. PST",2024,2053,1237,-787
BANC,"11/27/2017 11 p.m. PST",1861,1893,1313,-548
BANC,"11/28/2017 12 a.m. PST",1722,1727,1270,-452
BANC,"11/28/2017 1 a.m. PST",1631,1601,1209,-422
BANC,"11/28/2017 2 a.m. PST",1569,1552,1184,-385
BANC,"11/28/2017 3 a.m. PST",1545,1527,1125,-420
BANC,"11/28/2017 4 a.m. PST",1549,1530,1099,-450
BANC,"11/28/2017 5 a.m. PST",1607,1589,1169,-438
BANC,"11/28/2017 6 a.m. PST",1753,1738,1246,-507
BANC,"11/28/2017 7 a.m. PST",1968,1973,1261,-707
BANC,"11/28/2017 8 a.m. PST",2046,2080,1253,-793
BANC,"11/28/2017 9 a.m. PST",2003,2055,1190,-813
BANC,"11/28/2017 10 a.m. PST",1954,2039,1192,-762
BANC,"11/28/2017 11 a.m. PST",1916,2019,1105,-811
BANC,"11/28/2017 12 p.m. PST",1901,1990,1089,-812
BANC,"11/28/2017 1 p.m. PST",1893,1960,1133,-760
BANC,"11/28/2017 2 p.m. PST",1891,1949,1146,-745
BANC,"11/28/2017 3 p.m. PST",1906,1935,1173,-733
BANC,"11/28/2017 4 p.m. PST",1949,1953,1134,-815
BANC,"11/28/2017 5 p.m. PST",2029,2052,1375,-654
BANC,"11/28/2017 6 p.m. PST",2228,2293,1620,-608
BANC,"11/28/2017 7 p.m. PST",2255,2308,1592,-663
BANC,"11/28/2017 8 p.m. PST",2231,2270,1338,-893
BANC,"11/28/2017 9 p.m. PST",2172,2215,1263,-909
BANC,"11/28/2017 10 p.m. PST",2057,2093,1226,-831
BANC,"11/28/2017 11 p.m. PST",1898,1913,1189,-709
BANC,"11/29/2017 12 a.m. PST",1769,1747,1139,-630
BANC,"11/29/2017 1 a.m. PST",1660,1605,1174,-486
BANC,"11/29/2017 2 a.m. PST",1596,1551,1153,-443
BANC,"11/29/2017 3 a.m. PST",1580,1527,1081,-499
BANC,"11/29/2017 4 a.m. PST",1580,1536,1094,-486
BANC,"11/29/2017 5 a.m. PST",1640,1591,1162,-478
BANC,"11/29/2017 6 a.m. PST",1780,1736,1202,-578
BANC,"11/29/2017 7 a.m. PST",1993,1968,1310,-683
BANC,"11/29/2017 8 a.m. PST",2078,2045,1323,-755
BANC,"11/29/2017 9 a.m. PST",2065,2010,1320,-745
BANC,"11/29/2017 10 a.m. PST",2039,2006,1302,-737
BANC,"11/29/2017 11 a.m. PST",2002,1986,1334,-668
BANC,"11/29/2017 12 p.m. PST",1957,1966,1257,-700
BANC,"11/29/2017 1 p.m. PST",1921,1949,1237,-684
BANC,"11/29/2017 2 p.m. PST",1900,1932,1199,-701
BANC,"11/29/2017 3 p.m. PST",1916,1929,1269,-647
BANC,"11/29/2017 4 p.m. PST",1926,1941,1302,-624
BANC,"11/29/2017 5 p.m. PST",2032,2058,1481,-551
BANC,"11/29/2017 6 p.m. PST",2222,2270,1745,-477
BANC,"11/29/2017 7 p.m. PST",2241,2286,1680,-561
BANC,"11/29/2017 8 p.m. PST",2220,2263,1521,-699
BANC,"11/29/2017 9 p.m. PST",2164,2202,1353,-811
BANC,"11/29/2017 10 p.m. PST",2044,2093,1308,-736
BANC,"11/29/2017 11 p.m. PST",1882,1922,1245,-637
BANC,"11/30/2017 12 a.m. PST",1743,1757,1212,-531
BANC,"11/30/2017 1 a.m. PST",1642,1636,1205,-437
BANC,"11/30/2017 2 a.m. PST",1588,1591,1148,-440
BANC,"11/30/2017 3 a.m. PST",1568,1562,1185,-383
BANC,"11/30/2017 4 a.m. PST",1581,1568,1204,-377
BANC,"11/30/2017 5 a.m. PST",1636,1632,1209,-427
BANC,"11/30/2017 6 a.m. PST",1781,1780,1255,-526
BANC,"11/30/2017 7 a.m. PST",2008,2008,1284,-724
BANC,"11/30/2017 8 a.m. PST",2070,2067,1315,-755
BANC,"11/30/2017 9 a.m. PST",2067,2044,1333,-734
BANC,"11/30/2017 10 a.m. PST",1999,2006,1212,-787
BANC,"11/30/2017 11 a.m. PST",1972,1972,1219,-753
BANC,"11/30/2017 12 p.m. PST",1923,1946,1074,-849
BANC,"11/30/2017 1 p.m. PST",1914,1928,1111,-803
BANC,"11/30/2017 2 p.m. PST",1909,1917,1241,-668
BANC,"11/30/2017 3 p.m. PST",1896,1908,1239,-657
BANC,"11/30/2017 4 p.m. PST",1919,1929,1229,-690
BANC,"11/30/2017 5 p.m. PST",2014,2046,1427,-587
BANC,"11/30/2017 6 p.m. PST",2183,2265,1753,-430
BANC,"11/30/2017 7 p.m. PST",2206,2271,1581,-625
BANC,"11/30/2017 8 p.m. PST",2184,2249,1490,-694
BANC,"11/30/2017 9 p.m. PST",2140,2197,1415,-725
BANC,"11/30/2017 10 p.m. PST",2036,2093,1365,-671
BANC,"11/30/2017 11 p.m. PST",1894,1929,1347,-547
BANC,"12/1/2017 12 a.m. PST",1764,1770,1259,-505
