"BA Code","Timestamp (Hour Ending)","Demand (MWh)","Demand Forecast (MWh)","Net Generation (MWh)","Total Interchange (MWh)"
BANC,"2/1/2016 12 a.m. PST",1731,1639,1407,-324
BANC,"2/1/2016 1 a.m. PST",1624,1588,1313,-311
BANC,"2/1/2016 2 a.m. PST",1580,1548,1268,-312
BANC,"2/1/2016 3 a.m. PST",1563,1536,1200,-363
BANC,"2/1/2016 4 a.m. PST",1585,1548,1246,-339
BANC,"2/1/2016 5 a.m. PST",1633,1607,1310,-323
BANC,"2/1/2016 6 a.m. PST",1821,1771,1432,-389
BANC,"2/1/2016 7 a.m. PST",2072,2027,1474,-598
BANC,"2/1/2016 8 a.m. PST",2171,2128,1522,-649
BANC,"2/1/2016 9 a.m. PST",2112,2052,1424,-688
BANC,"2/1/2016 10 a.m. PST",2077,2031,1322,-755
BANC,"2/1/2016 11 a.m. PST",2029,2043,1348,-681
BANC,"2/1/2016 12 p.m. PST",1983,2006,1300,-683
BANC,"2/1/2016 1 p.m. PST",1940,1946,1269,-671
BANC,"2/1/2016 2 p.m. PST",1900,1912,1256,-644
BANC,"2/1/2016 3 p.m. PST",1868,1884,1223,-645
BANC,"2/1/2016 4 p.m. PST",1881,1877,1240,-641
BANC,"2/1/2016 5 p.m. PST",1930,1932,1274,-656
BANC,"2/1/2016 6 p.m. PST",2137,2094,1687,-450
BANC,"2/1/2016 7 p.m. PST",2254,2233,1854,-400
BANC,"2/1/2016 8 p.m. PST",2268,2209,1556,-712
BANC,"2/1/2016 9 p.m. PST",2213,2165,1510,-703
BANC,"2/1/2016 10 p.m. PST",2110,2047,1498,-612
BANC,"2/1/2016 11 p.m. PST",1947,1890,1518,-429
BANC,"2/2/2016 12 a.m. PST",1787,1736,1406,-381
BANC,"2/2/2016 1 a.m. PST",1688,1651,1306,-382
BANC,"2/2/2016 2 a.m. PST",1631,1608,1262,-369
BANC,"2/2/2016 3 a.m. PST",1602,1582,1225,-377
BANC,"2/2/2016 4 a.m. PST",1625,1605,1250,-375
BANC,"2/2/2016 5 a.m. PST",1682,1662,1307,-375
BANC,"2/2/2016 6 a.m. PST",1824,1820,1399,-425
BANC,"2/2/2016 7 a.m. PST",2049,2051,1450,-599
BANC,"2/2/2016 8 a.m. PST",2142,2124,1462,-680
BANC,"2/2/2016 9 a.m. PST",2120,2077,1437,-683
BANC,"2/2/2016 10 a.m. PST",2112,2046,1424,-688
BANC,"2/2/2016 11 a.m. PST",2099,2042,1397,-702
BANC,"2/2/2016 12 p.m. PST",2059,1990,1390,-669
BANC,"2/2/2016 1 p.m. PST",2009,1930,1321,-688
BANC,"2/2/2016 2 p.m. PST",1985,1902,1311,-674
BANC,"2/2/2016 3 p.m. PST",1961,1903,1293,-668
BANC,"2/2/2016 4 p.m. PST",1962,1893,1280,-682
BANC,"2/2/2016 5 p.m. PST",2022,1954,1399,-623
BANC,"2/2/2016 6 p.m. PST",2172,2105,1839,-333
BANC,"2/2/2016 7 p.m. PST",2284,2213,1876,-408
BANC,"2/2/2016 8 p.m. PST",2276,2186,1539,-737
BANC,"2/2/2016 9 p.m. PST",2218,2133,1452,-766
BANC,"2/2/2016 10 p.m. PST",2108,2006,1429,-679
BANC,"2/2/2016 11 p.m. PST",1937,1868,1468,-469
BANC,"2/3/2016 12 a.m. PST",1788,1699,1357,-431
BANC,"2/3/2016 1 a.m. PST",1686,1649,1246,-440
BANC,"2/3/2016 2 a.m. PST",1641,1593,1235,-406
BANC,"2/3/2016 3 a.m. PST",1626,1578,1202,-424
BANC,"2/3/2016 4 a.m. PST",1633,1591,1202,-431
BANC,"2/3/2016 5 a.m. PST",1708,1645,1281,-427
BANC,"2/3/2016 6 a.m. PST",1859,1791,1368,-491
BANC,"2/3/2016 7 a.m. PST",2115,2020,1432,-683
BANC,"2/3/2016 8 a.m. PST",2205,2135,1490,-715
BANC,"2/3/2016 9 a.m. PST",2170,2093,1397,-773
BANC,"2/3/2016 10 a.m. PST",2131,2070,1331,-800
BANC,"2/3/2016 11 a.m. PST",2094,2048,1310,-784
BANC,"2/3/2016 12 p.m. PST",2015,2001,1298,-717
BANC,"2/3/2016 1 p.m. PST",1958,1968,1229,-729
BANC,"2/3/2016 2 p.m. PST",1916,1943,1201,-715
BANC,"2/3/2016 3 p.m. PST",1921,1934,1210,-711
BANC,"2/3/2016 4 p.m. PST",1943,1936,1236,-707
BANC,"2/3/2016 5 p.m. PST",2021,2001,1322,-699
BANC,"2/3/2016 6 p.m. PST",2171,2175,1910,-261
BANC,"2/3/2016 7 p.m. PST",2249,2245,2045,-204
BANC,"2/3/2016 8 p.m. PST",2221,2204,1520,-701
BANC,"2/3/2016 9 p.m. PST",2151,2160,1455,-696
BANC,"2/3/2016 10 p.m. PST",2037,2059,1321,-716
BANC,"2/3/2016 11 p.m. PST",1870,1907,1349,-521
BANC,"2/4/2016 12 a.m. PST",1714,1747,1219,-495
BANC,"2/4/2016 1 a.m. PST",1607,1628,1120,-487
BANC,"2/4/2016 2 a.m. PST",1556,1571,1110,-446
BANC,"2/4/2016 3 a.m. PST",1525,1554,1073,-452
BANC,"2/4/2016 4 a.m. PST",1535,1564,1085,-450
BANC,"2/4/2016 5 a.m. PST",1597,1623,1190,-407
BANC,"2/4/2016 6 a.m. PST",1753,1764,1271,-482
BANC,"2/4/2016 7 a.m. PST",2007,1992,1380,-627
BANC,"2/4/2016 8 a.m. PST",2092,2099,1458,-634
BANC,"2/4/2016 9 a.m. PST",2057,2063,1410,-647
BANC,"2/4/2016 10 a.m. PST",2031,2008,1387,-644
BANC,"2/4/2016 11 a.m. PST",1991,1986,1347,-644
BANC,"2/4/2016 12 p.m. PST",1956,1954,1387,-569
BANC,"2/4/2016 1 p.m. PST",1900,1925,1336,-564
BANC,"2/4/2016 2 p.m. PST",1835,1900,1247,-588
BANC,"2/4/2016 3 p.m. PST",1826,1878,1235,-591
BANC,"2/4/2016 4 p.m. PST",1831,1872,1231,-600
BANC,"2/4/2016 5 p.m. PST",1884,1904,1289,-595
BANC,"2/4/2016 6 p.m. PST",2034,2080,1396,-638
BANC,"2/4/2016 7 p.m. PST",2166,2185,1818,-348
BANC,"2/4/2016 8 p.m. PST",2151,2149,1745,-406
BANC,"2/4/2016 9 p.m. PST",2113,2100,1511,-602
BANC,"2/4/2016 10 p.m. PST",2018,2006,1450,-568
BANC,"2/4/2016 11 p.m. PST",1861,1846,1359,-502
BANC,"2/5/2016 12 a.m. PST",1713,1690,1280,-433
BANC,"2/5/2016 1 a.m. PST",1610,1599,1420,-190
BANC,"2/5/2016 2 a.m. PST",1552,1542,1252,-300
BANC,"2/5/2016 3 a.m. PST",1542,1527,1195,-347
BANC,"2/5/2016 4 a.m. PST",1547,1537,1256,-291
BANC,"2/5/2016 5 a.m. PST",1618,1601,1355,-263
BANC,"2/5/2016 6 a.m. PST",1782,1739,1437,-345
BANC,"2/5/2016 7 a.m. PST",2030,1975,1532,-498
BANC,"2/5/2016 8 a.m. PST",2124,2079,1602,-522
BANC,"2/5/2016 9 a.m. PST",2070,2024,1528,-542
BANC,"2/5/2016 10 a.m. PST",2005,2007,1509,-496
BANC,"2/5/2016 11 a.m. PST",1944,1988,1455,-489
BANC,"2/5/2016 12 p.m. PST",1896,1942,1408,-488
BANC,"2/5/2016 1 p.m. PST",1844,1905,1372,-472
BANC,"2/5/2016 2 p.m. PST",1827,1885,1355,-472
BANC,"2/5/2016 3 p.m. PST",1801,1860,1331,-470
BANC,"2/5/2016 4 p.m. PST",1797,1855,1320,-477
BANC,"2/5/2016 5 p.m. PST",1843,1908,1320,-523
BANC,"2/5/2016 6 p.m. PST",1952,2074,1417,-535
BANC,"2/5/2016 7 p.m. PST",2067,2163,1703,-364
BANC,"2/5/2016 8 p.m. PST",2045,2122,1669,-376
BANC,"2/5/2016 9 p.m. PST",2009,2076,1426,-583
BANC,"2/5/2016 10 p.m. PST",1936,1974,1467,-469
BANC,"2/5/2016 11 p.m. PST",1819,1829,1364,-455
BANC,"2/6/2016 12 a.m. PST",1690,1678,1371,-319
BANC,"2/6/2016 1 a.m. PST",1581,1553,1362,-219
BANC,"2/6/2016 2 a.m. PST",1532,1480,1162,-370
BANC,"2/6/2016 3 a.m. PST",1490,1442,1151,-339
BANC,"2/6/2016 4 a.m. PST",1494,1438,1161,-333
BANC,"2/6/2016 5 a.m. PST",1524,1466,1182,-342
BANC,"2/6/2016 6 a.m. PST",1587,1536,1215,-372
BANC,"2/6/2016 7 a.m. PST",1702,1665,1228,-474
BANC,"2/6/2016 8 a.m. PST",1790,1745,1293,-497
BANC,"2/6/2016 9 a.m. PST",1831,1806,1342,-489
BANC,"2/6/2016 10 a.m. PST",1814,1851,1397,-417
BANC,"2/6/2016 11 a.m. PST",1799,1855,1393,-406
BANC,"2/6/2016 12 p.m. PST",1750,1841,1341,-409
BANC,"2/6/2016 1 p.m. PST",1698,1798,1270,-428
BANC,"2/6/2016 2 p.m. PST",1663,1764,1243,-420
BANC,"2/6/2016 3 p.m. PST",1637,1733,1209,-428
BANC,"2/6/2016 4 p.m. PST",1653,1720,1238,-415
BANC,"2/6/2016 5 p.m. PST",1705,1749,1333,-372
BANC,"2/6/2016 6 p.m. PST",1831,1896,1414,-417
BANC,"2/6/2016 7 p.m. PST",1939,2033,1764,-175
BANC,"2/6/2016 8 p.m. PST",1920,2002,1750,-170
BANC,"2/6/2016 9 p.m. PST",1917,1963,1525,-392
BANC,"2/6/2016 10 p.m. PST",1851,1885,1499,-352
BANC,"2/6/2016 11 p.m. PST",1749,1771,1451,-298
BANC,"2/7/2016 12 a.m. PST",1627,1642,1410,-217
BANC,"2/7/2016 1 a.m. PST",1535,1508,1296,-239
BANC,"2/7/2016 2 a.m. PST",1472,1449,1253,-219
BANC,"2/7/2016 3 a.m. PST",1434,1416,1224,-210
BANC,"2/7/2016 4 a.m. PST",1443,1416,1246,-197
BANC,"2/7/2016 5 a.m. PST",1459,1430,1279,-180
BANC,"2/7/2016 6 a.m. PST",1528,1490,1334,-194
BANC,"2/7/2016 7 a.m. PST",1622,1584,1441,-181
BANC,"2/7/2016 8 a.m. PST",1684,1631,1418,-266
BANC,"2/7/2016 9 a.m. PST",1727,1712,1409,-318
BANC,"2/7/2016 10 a.m. PST",1733,1749,1387,-346
BANC,"2/7/2016 11 a.m. PST",1737,1747,1380,-357
BANC,"2/7/2016 12 p.m. PST",1713,1741,1412,-301
BANC,"2/7/2016 1 p.m. PST",1701,1710,1340,-361
BANC,"2/7/2016 2 p.m. PST",1683,1703,1329,-354
BANC,"2/7/2016 3 p.m. PST",1665,1682,1320,-345
BANC,"2/7/2016 4 p.m. PST",1641,1659,1295,-346
BANC,"2/7/2016 5 p.m. PST",1652,1673,1382,-270
BANC,"2/7/2016 6 p.m. PST",1751,1819,1419,-332
BANC,"2/7/2016 7 p.m. PST",1871,1918,1774,-97
BANC,"2/7/2016 8 p.m. PST",1868,1912,1762,-106
BANC,"2/7/2016 9 p.m. PST",1887,1913,1532,-355
BANC,"2/7/2016 10 p.m. PST",1816,1843,1445,-371
BANC,"2/7/2016 11 p.m. PST",1684,1703,1420,-264
BANC,"2/8/2016 12 a.m. PST",1561,1564,1308,-253
BANC,"2/8/2016 1 a.m. PST",1470,1500,1208,-262
BANC,"2/8/2016 2 a.m. PST",1422,1446,1160,-262
BANC,"2/8/2016 3 a.m. PST",1416,1425,1162,-254
BANC,"2/8/2016 4 a.m. PST",1423,1436,1250,-173
BANC,"2/8/2016 5 a.m. PST",1482,1495,1330,-152
BANC,"2/8/2016 6 a.m. PST",1638,1638,1441,-197
BANC,"2/8/2016 7 a.m. PST",1848,1875,1468,-380
BANC,"2/8/2016 8 a.m. PST",1916,1956,1631,-285
BANC,"2/8/2016 9 a.m. PST",1923,1935,1500,-423
BANC,"2/8/2016 10 a.m. PST",1907,1916,1597,-310
BANC,"2/8/2016 11 a.m. PST",1907,1886,1573,-334
BANC,"2/8/2016 12 p.m. PST",1876,1876,1562,-314
BANC,"2/8/2016 1 p.m. PST",1867,1859,1586,-281
BANC,"2/8/2016 2 p.m. PST",1867,1853,1605,-262
BANC,"2/8/2016 3 p.m. PST",1853,1840,1642,-211
BANC,"2/8/2016 4 p.m. PST",1868,1837,1602,-266
BANC,"2/8/2016 5 p.m. PST",1875,1861,1571,-304
BANC,"2/8/2016 6 p.m. PST",1990,1982,1580,-410
BANC,"2/8/2016 7 p.m. PST",2092,2071,1810,-282
BANC,"2/8/2016 8 p.m. PST",2079,2030,1861,-218
BANC,"2/8/2016 9 p.m. PST",2011,1974,1564,-447
BANC,"2/8/2016 10 p.m. PST",1885,1882,1500,-385
BANC,"2/8/2016 11 p.m. PST",1738,1747,1413,-325
BANC,"2/9/2016 12 a.m. PST",1599,1607,1362,-237
BANC,"2/9/2016 1 a.m. PST",1498,1530,1143,-355
BANC,"2/9/2016 2 a.m. PST",1446,1472,1094,-352
BANC,"2/9/2016 3 a.m. PST",1426,1451,1074,-352
BANC,"2/9/2016 4 a.m. PST",1433,1462,1100,-333
BANC,"2/9/2016 5 a.m. PST",1499,1517,1254,-245
BANC,"2/9/2016 6 a.m. PST",1648,1653,1370,-278
BANC,"2/9/2016 7 a.m. PST",1884,1883,1532,-352
BANC,"2/9/2016 8 a.m. PST",1963,1966,1630,-333
BANC,"2/9/2016 9 a.m. PST",1924,1943,1523,-401
BANC,"2/9/2016 10 a.m. PST",1888,1919,1472,-416
BANC,"2/9/2016 11 a.m. PST",1870,1893,1498,-372
BANC,"2/9/2016 12 p.m. PST",1860,1878,1442,-418
BANC,"2/9/2016 1 p.m. PST",1829,1867,1411,-418
BANC,"2/9/2016 2 p.m. PST",1854,1861,1437,-417
BANC,"2/9/2016 3 p.m. PST",1834,1856,1508,-326
BANC,"2/9/2016 4 p.m. PST",1850,1859,1576,-274
BANC,"2/9/2016 5 p.m. PST",1877,1878,1552,-325
BANC,"2/9/2016 6 p.m. PST",1971,1965,1550,-421
BANC,"2/9/2016 7 p.m. PST",2082,2078,1897,-185
BANC,"2/9/2016 8 p.m. PST",2049,2050,1876,-173
BANC,"2/9/2016 9 p.m. PST",1990,1997,1561,-429
BANC,"2/9/2016 10 p.m. PST",1884,1900,1454,-430
BANC,"2/9/2016 11 p.m. PST",1721,1775,1465,-256
BANC,"2/10/2016 12 a.m. PST",1589,1621,1369,-220
BANC,"2/10/2016 1 a.m. PST",1502,1518,1229,-273
BANC,"2/10/2016 2 a.m. PST",1445,1460,1207,-238
BANC,"2/10/2016 3 a.m. PST",1430,1438,1121,-309
BANC,"2/10/2016 4 a.m. PST",1429,1446,1110,-319
BANC,"2/10/2016 5 a.m. PST",1492,1497,1180,-312
BANC,"2/10/2016 6 a.m. PST",1635,1631,1366,-269
BANC,"2/10/2016 7 a.m. PST",1872,1843,1481,-391
BANC,"2/10/2016 8 a.m. PST",1960,1921,1580,-380
BANC,"2/10/2016 9 a.m. PST",1912,1910,1432,-480
BANC,"2/10/2016 10 a.m. PST",1899,1899,1436,-463
BANC,"2/10/2016 11 a.m. PST",1897,1888,1445,-452
BANC,"2/10/2016 12 p.m. PST",1883,1878,1475,-408
BANC,"2/10/2016 1 p.m. PST",1846,1866,1436,-410
BANC,"2/10/2016 2 p.m. PST",1820,1858,1436,-384
BANC,"2/10/2016 3 p.m. PST",1824,1851,1436,-388
BANC,"2/10/2016 4 p.m. PST",1846,1846,1376,-470
BANC,"2/10/2016 5 p.m. PST",1872,1867,1321,-551
BANC,"2/10/2016 6 p.m. PST",1970,1961,1723,-247
BANC,"2/10/2016 7 p.m. PST",2098,2094,1855,-243
BANC,"2/10/2016 8 p.m. PST",2076,2064,1634,-442
BANC,"2/10/2016 9 p.m. PST",2013,1999,1530,-483
BANC,"2/10/2016 10 p.m. PST",1904,1887,1451,-453
BANC,"2/10/2016 11 p.m. PST",1754,1750,1491,-263
BANC,"2/11/2016 12 a.m. PST",1615,1604,1335,-280
BANC,"2/11/2016 1 a.m. PST",1524,1518,1123,-401
BANC,"2/11/2016 2 a.m. PST",1455,1465,1062,-393
BANC,"2/11/2016 3 a.m. PST",1447,1440,1036,-411
BANC,"2/11/2016 4 a.m. PST",1453,1448,1044,-409
BANC,"2/11/2016 5 a.m. PST",1511,1496,1106,-405
BANC,"2/11/2016 6 a.m. PST",1641,1639,1292,-349
BANC,"2/11/2016 7 a.m. PST",1858,1862,1375,-483
BANC,"2/11/2016 8 a.m. PST",1939,1949,1616,-323
BANC,"2/11/2016 9 a.m. PST",1907,1924,1461,-446
BANC,"2/11/2016 10 a.m. PST",1876,1913,1362,-514
BANC,"2/11/2016 11 a.m. PST",1861,1886,1378,-483
BANC,"2/11/2016 12 p.m. PST",1866,1870,1413,-453
BANC,"2/11/2016 1 p.m. PST",1883,1865,1432,-451
BANC,"2/11/2016 2 p.m. PST",1889,1864,1436,-453
BANC,"2/11/2016 3 p.m. PST",1864,1857,1506,-358
BANC,"2/11/2016 4 p.m. PST",1842,1849,1383,-459
BANC,"2/11/2016 5 p.m. PST",1871,1865,1374,-497
BANC,"2/11/2016 6 p.m. PST",1980,1968,1603,-377
BANC,"2/11/2016 7 p.m. PST",2079,2074,1931,-148
BANC,"2/11/2016 8 p.m. PST",2054,2044,1911,-143
BANC,"2/11/2016 9 p.m. PST",2007,1976,1474,-533
BANC,"2/11/2016 10 p.m. PST",1899,1880,1428,-471
BANC,"2/11/2016 11 p.m. PST",1753,1748,1435,-318
BANC,"2/12/2016 12 a.m. PST",1624,1615,1303,-321
BANC,"2/12/2016 1 a.m. PST",1515,1538,1140,-375
BANC,"2/12/2016 2 a.m. PST",1462,1483,1039,-423
BANC,"2/12/2016 3 a.m. PST",1434,1455,1022,-412
BANC,"2/12/2016 4 a.m. PST",1451,1463,1031,-420
BANC,"2/12/2016 5 a.m. PST",1503,1512,1097,-406
BANC,"2/12/2016 6 a.m. PST",1639,1651,1249,-390
BANC,"2/12/2016 7 a.m. PST",1843,1879,1478,-365
BANC,"2/12/2016 8 a.m. PST",1944,1960,1537,-407
BANC,"2/12/2016 9 a.m. PST",1913,1945,1524,-389
BANC,"2/12/2016 10 a.m. PST",1892,1941,1446,-446
BANC,"2/12/2016 11 a.m. PST",1869,1934,1387,-482
BANC,"2/12/2016 12 p.m. PST",1858,1916,1373,-485
BANC,"2/12/2016 1 p.m. PST",1843,1899,1424,-419
BANC,"2/12/2016 2 p.m. PST",1874,1885,1460,-414
BANC,"2/12/2016 3 p.m. PST",1854,1872,1470,-384
BANC,"2/12/2016 4 p.m. PST",1841,1864,1418,-423
BANC,"2/12/2016 5 p.m. PST",1872,1886,1576,-296
BANC,"2/12/2016 6 p.m. PST",1961,1969,1613,-348
BANC,"2/12/2016 7 p.m. PST",2055,2080,2045,-10
BANC,"2/12/2016 8 p.m. PST",2006,2043,1982,-24
BANC,"2/12/2016 9 p.m. PST",1952,1978,1544,-408
BANC,"2/12/2016 10 p.m. PST",1867,1892,1404,-463
BANC,"2/12/2016 11 p.m. PST",1769,1769,1411,-358
BANC,"2/13/2016 12 a.m. PST",1625,1645,1252,-373
BANC,"2/13/2016 1 a.m. PST",1531,1524,1149,-382
BANC,"2/13/2016 2 a.m. PST",1474,1467,1041,-433
BANC,"2/13/2016 3 a.m. PST",1437,1432,1024,-413
BANC,"2/13/2016 4 a.m. PST",1425,1414,1003,-422
BANC,"2/13/2016 5 a.m. PST",1453,1437,1075,-378
BANC,"2/13/2016 6 a.m. PST",1494,1487,1146,-348
BANC,"2/13/2016 7 a.m. PST",1613,1586,1205,-408
BANC,"2/13/2016 8 a.m. PST",1641,1622,1278,-363
BANC,"2/13/2016 9 a.m. PST",1696,1696,1282,-414
BANC,"2/13/2016 10 a.m. PST",1715,1724,1282,-433
BANC,"2/13/2016 11 a.m. PST",1730,1747,1297,-433
BANC,"2/13/2016 12 p.m. PST",1703,1723,1279,-424
BANC,"2/13/2016 1 p.m. PST",1680,1710,1248,-432
BANC,"2/13/2016 2 p.m. PST",1667,1683,1232,-435
BANC,"2/13/2016 3 p.m. PST",1645,1686,1210,-435
BANC,"2/13/2016 4 p.m. PST",1653,1680,1211,-442
BANC,"2/13/2016 5 p.m. PST",1710,1716,1409,-301
BANC,"2/13/2016 6 p.m. PST",1798,1807,1595,-203
BANC,"2/13/2016 7 p.m. PST",1908,1947,2049,141
BANC,"2/13/2016 8 p.m. PST",1909,1918,1952,43
BANC,"2/13/2016 9 p.m. PST",1879,1858,1670,-209
BANC,"2/13/2016 10 p.m. PST",1799,1790,1528,-271
BANC,"2/13/2016 11 p.m. PST",1709,1685,1378,-331
BANC,"2/14/2016 12 a.m. PST",1589,1574,1246,-343
BANC,"2/14/2016 1 a.m. PST",1506,1495,1152,-354
BANC,"2/14/2016 2 a.m. PST",1439,1439,1089,-350
BANC,"2/14/2016 3 a.m. PST",1411,1405,1060,-351
BANC,"2/14/2016 4 a.m. PST",1408,1397,1025,-383
BANC,"2/14/2016 5 a.m. PST",1420,1407,1056,-364
BANC,"2/14/2016 6 a.m. PST",1456,1453,1056,-400
BANC,"2/14/2016 7 a.m. PST",1554,1531,1208,-346
BANC,"2/14/2016 8 a.m. PST",1583,1577,1245,-338
BANC,"2/14/2016 9 a.m. PST",1644,1639,1250,-394
BANC,"2/14/2016 10 a.m. PST",1692,1666,1338,-354
BANC,"2/14/2016 11 a.m. PST",1675,1687,1245,-430
BANC,"2/14/2016 12 p.m. PST",1654,1687,1274,-380
BANC,"2/14/2016 1 p.m. PST",1628,1678,1182,-446
BANC,"2/14/2016 2 p.m. PST",1620,1660,1186,-434
BANC,"2/14/2016 3 p.m. PST",1628,1668,1215,-413
BANC,"2/14/2016 4 p.m. PST",1670,1654,1292,-378
BANC,"2/14/2016 5 p.m. PST",1706,1691,1342,-364
BANC,"2/14/2016 6 p.m. PST",1795,1789,1462,-333
BANC,"2/14/2016 7 p.m. PST",1946,1951,1943,-3
BANC,"2/14/2016 8 p.m. PST",1921,1934,1823,-98
BANC,"2/14/2016 9 p.m. PST",1870,1883,1520,-350
BANC,"2/14/2016 10 p.m. PST",1800,1804,1530,-270
BANC,"2/14/2016 11 p.m. PST",1686,1696,1341,-345
BANC,"2/15/2016 12 a.m. PST",1568,1575,1206,-362
BANC,"2/15/2016 1 a.m. PST",1465,1466,1149,-316
BANC,"2/15/2016 2 a.m. PST",1423,1413,1132,-291
BANC,"2/15/2016 3 a.m. PST",1410,1384,1134,-276
BANC,"2/15/2016 4 a.m. PST",1401,1380,1112,-289
BANC,"2/15/2016 5 a.m. PST",1427,1420,1134,-293
BANC,"2/15/2016 6 a.m. PST",1506,1509,1220,-286
BANC,"2/15/2016 7 a.m. PST",1612,1631,1305,-307
BANC,"2/15/2016 8 a.m. PST",1671,1674,1327,-344
BANC,"2/15/2016 9 a.m. PST",1716,1727,1301,-415
BANC,"2/15/2016 10 a.m. PST",1766,1783,1332,-434
BANC,"2/15/2016 11 a.m. PST",1793,1805,1370,-423
BANC,"2/15/2016 12 p.m. PST",1814,1815,1379,-435
BANC,"2/15/2016 1 p.m. PST",1793,1803,1350,-443
BANC,"2/15/2016 2 p.m. PST",1817,1797,1391,-426
BANC,"2/15/2016 3 p.m. PST",1831,1804,1404,-427
BANC,"2/15/2016 4 p.m. PST",1826,1807,1394,-432
BANC,"2/15/2016 5 p.m. PST",1866,1838,1500,-366
BANC,"2/15/2016 6 p.m. PST",1957,1931,1646,-311
BANC,"2/15/2016 7 p.m. PST",2092,2085,2067,-25
BANC,"2/15/2016 8 p.m. PST",2067,2056,1736,-331
BANC,"2/15/2016 9 p.m. PST",2007,1976,1575,-432
BANC,"2/15/2016 10 p.m. PST",1869,1867,1477,-392
BANC,"2/15/2016 11 p.m. PST",1720,1721,1485,-235
BANC,"2/16/2016 12 a.m. PST",1589,1571,1294,-295
BANC,"2/16/2016 1 a.m. PST",1508,1518,1203,-305
BANC,"2/16/2016 2 a.m. PST",1419,1459,1110,-309
BANC,"2/16/2016 3 a.m. PST",1399,1441,1093,-306
BANC,"2/16/2016 4 a.m. PST",1409,1445,1100,-309
BANC,"2/16/2016 5 a.m. PST",1456,1502,1126,-330
BANC,"2/16/2016 6 a.m. PST",1577,1626,1254,-323
BANC,"2/16/2016 7 a.m. PST",1779,1858,1372,-407
BANC,"2/16/2016 8 a.m. PST",1848,1948,1364,-484
BANC,"2/16/2016 9 a.m. PST",1842,1920,1314,-528
BANC,"2/16/2016 10 a.m. PST",1862,1899,1409,-453
BANC,"2/16/2016 11 a.m. PST",1870,1886,1396,-474
BANC,"2/16/2016 12 p.m. PST",1895,1877,1417,-478
BANC,"2/16/2016 1 p.m. PST",1901,1868,1425,-476
BANC,"2/16/2016 2 p.m. PST",1928,1863,1500,-428
BANC,"2/16/2016 3 p.m. PST",1948,1856,1502,-446
BANC,"2/16/2016 4 p.m. PST",1938,1864,1508,-430
BANC,"2/16/2016 5 p.m. PST",1949,1889,1515,-434
BANC,"2/16/2016 6 p.m. PST",2005,1985,1756,-249
BANC,"2/16/2016 7 p.m. PST",2153,2108,2030,-123
BANC,"2/16/2016 8 p.m. PST",2101,2076,1611,-490
BANC,"2/16/2016 9 p.m. PST",2018,2001,1531,-487
BANC,"2/16/2016 10 p.m. PST",1899,1912,1460,-439
BANC,"2/16/2016 11 p.m. PST",1747,1756,1365,-382
BANC,"2/17/2016 12 a.m. PST",1587,1611,1222,-365
BANC,"2/17/2016 1 a.m. PST",1508,1537,1068,-440
BANC,"2/17/2016 2 a.m. PST",1458,1482,1000,-458
BANC,"2/17/2016 3 a.m. PST",1432,1455,968,-464
BANC,"2/17/2016 4 a.m. PST",1421,1456,986,-435
BANC,"2/17/2016 5 a.m. PST",1465,1504,1025,-440
BANC,"2/17/2016 6 a.m. PST",1578,1628,1121,-457
BANC,"2/17/2016 7 a.m. PST",1781,1825,1283,-498
BANC,"2/17/2016 8 a.m. PST",1897,1913,1380,-517
BANC,"2/17/2016 9 a.m. PST",1911,1906,1239,-672
BANC,"2/17/2016 10 a.m. PST",1959,1908,1250,-709
BANC,"2/17/2016 11 a.m. PST",2005,1905,1363,-642
BANC,"2/17/2016 12 p.m. PST",1969,1882,1285,-684
BANC,"2/17/2016 1 p.m. PST",1953,1883,1248,-705
BANC,"2/17/2016 2 p.m. PST",1940,1876,1283,-657
BANC,"2/17/2016 3 p.m. PST",1939,1862,1316,-623
BANC,"2/17/2016 4 p.m. PST",1899,1872,1243,-656
BANC,"2/17/2016 5 p.m. PST",1894,1906,1146,-748
BANC,"2/17/2016 6 p.m. PST",2005,2017,1288,-717
BANC,"2/17/2016 7 p.m. PST",2112,2117,1749,-363
BANC,"2/17/2016 8 p.m. PST",2112,2079,1375,-737
BANC,"2/17/2016 9 p.m. PST",2036,2033,1264,-772
BANC,"2/17/2016 10 p.m. PST",1951,1949,1315,-636
BANC,"2/17/2016 11 p.m. PST",1784,1805,1243,-541
BANC,"2/18/2016 12 a.m. PST",1624,1663,1118,-506
BANC,"2/18/2016 1 a.m. PST",1537,1525,1028,-509
BANC,"2/18/2016 2 a.m. PST",1497,1466,1014,-483
BANC,"2/18/2016 3 a.m. PST",1455,1443,953,-502
BANC,"2/18/2016 4 a.m. PST",1463,1446,951,-512
BANC,"2/18/2016 5 a.m. PST",1503,1493,979,-524
BANC,"2/18/2016 6 a.m. PST",1624,1621,1077,-547
BANC,"2/18/2016 7 a.m. PST",1863,1830,1260,-603
BANC,"2/18/2016 8 a.m. PST",1934,1904,1277,-657
BANC,"2/18/2016 9 a.m. PST",1899,1917,1191,-708
BANC,"2/18/2016 10 a.m. PST",1902,1928,1180,-722
BANC,"2/18/2016 11 a.m. PST",1884,1941,1238,-646
BANC,"2/18/2016 12 p.m. PST",1907,1930,1278,-629
BANC,"2/18/2016 1 p.m. PST",1933,1912,1301,-632
BANC,"2/18/2016 2 p.m. PST",1896,1899,1264,-632
BANC,"2/18/2016 3 p.m. PST",1856,1876,1194,-662
BANC,"2/18/2016 4 p.m. PST",1849,1869,1203,-646
BANC,"2/18/2016 5 p.m. PST",1891,1901,1294,-597
BANC,"2/18/2016 6 p.m. PST",2003,2003,1296,-707
BANC,"2/18/2016 7 p.m. PST",2142,2131,1670,-472
BANC,"2/18/2016 8 p.m. PST",2130,2101,1384,-746
BANC,"2/18/2016 9 p.m. PST",2073,2041,1339,-734
BANC,"2/18/2016 10 p.m. PST",1964,1926,1293,-671
BANC,"2/18/2016 11 p.m. PST",1810,1794,1282,-528
BANC,"2/19/2016 12 a.m. PST",1678,1642,1212,-466
BANC,"2/19/2016 1 a.m. PST",1569,1552,1079,-490
BANC,"2/19/2016 2 a.m. PST",1521,1494,1102,-419
BANC,"2/19/2016 3 a.m. PST",1506,1473,1091,-415
BANC,"2/19/2016 4 a.m. PST",1500,1482,1089,-411
BANC,"2/19/2016 5 a.m. PST",1554,1535,1091,-463
BANC,"2/19/2016 6 a.m. PST",1687,1669,1208,-479
BANC,"2/19/2016 7 a.m. PST",1906,1891,1371,-535
BANC,"2/19/2016 8 a.m. PST",1979,1977,1402,-577
BANC,"2/19/2016 9 a.m. PST",1941,1955,1363,-578
BANC,"2/19/2016 10 a.m. PST",1923,1941,1352,-571
BANC,"2/19/2016 11 a.m. PST",1908,1933,1332,-576
BANC,"2/19/2016 12 p.m. PST",1917,1911,1317,-600
BANC,"2/19/2016 1 p.m. PST",1893,1885,1309,-584
BANC,"2/19/2016 2 p.m. PST",1867,1865,1285,-582
BANC,"2/19/2016 3 p.m. PST",1885,1865,1317,-568
BANC,"2/19/2016 4 p.m. PST",1885,1841,1306,-579
BANC,"2/19/2016 5 p.m. PST",1916,1876,1311,-605
BANC,"2/19/2016 6 p.m. PST",2007,1991,1814,-193
BANC,"2/19/2016 7 p.m. PST",2101,2121,1873,-228
BANC,"2/19/2016 8 p.m. PST",2064,2090,1457,-607
BANC,"2/19/2016 9 p.m. PST",2026,2033,1310,-716
BANC,"2/19/2016 10 p.m. PST",1930,1930,1241,-689
BANC,"2/19/2016 11 p.m. PST",1794,1797,1226,-568
BANC,"2/20/2016 12 a.m. PST",1672,1647,1098,-574
BANC,"2/20/2016 1 a.m. PST",1568,1541,1079,-489
BANC,"2/20/2016 2 a.m. PST",1513,1476,1057,-456
BANC,"2/20/2016 3 a.m. PST",1474,1449,1043,-431
BANC,"2/20/2016 4 a.m. PST",1478,1444,1050,-428
BANC,"2/20/2016 5 a.m. PST",1480,1469,1034,-446
BANC,"2/20/2016 6 a.m. PST",1539,1528,1103,-436
BANC,"2/20/2016 7 a.m. PST",1651,1621,1104,-547
BANC,"2/20/2016 8 a.m. PST",1672,1673,1091,-581
BANC,"2/20/2016 9 a.m. PST",1736,1738,1138,-598
BANC,"2/20/2016 10 a.m. PST",1760,1771,1175,-585
BANC,"2/20/2016 11 a.m. PST",1778,1778,1186,-592
BANC,"2/20/2016 12 p.m. PST",1765,1764,1187,-578
BANC,"2/20/2016 1 p.m. PST",1712,1731,1125,-587
BANC,"2/20/2016 2 p.m. PST",1660,1695,1092,-568
BANC,"2/20/2016 3 p.m. PST",1669,1677,1106,-563
BANC,"2/20/2016 4 p.m. PST",1643,1659,1096,-547
BANC,"2/20/2016 5 p.m. PST",1668,1690,1181,-487
BANC,"2/20/2016 6 p.m. PST",1761,1790,1645,-116
BANC,"2/20/2016 7 p.m. PST",1953,1973,1825,-128
BANC,"2/20/2016 8 p.m. PST",1945,1957,1454,-491
BANC,"2/20/2016 9 p.m. PST",1923,1907,1429,-494
BANC,"2/20/2016 10 p.m. PST",1862,1837,1416,-446
BANC,"2/20/2016 11 p.m. PST",1761,1743,1371,-390
BANC,"2/21/2016 12 a.m. PST",1644,1625,1234,-410
BANC,"2/21/2016 1 a.m. PST",1563,1507,1153,-410
BANC,"2/21/2016 2 a.m. PST",1508,1451,1112,-396
BANC,"2/21/2016 3 a.m. PST",1485,1423,1091,-394
BANC,"2/21/2016 4 a.m. PST",1483,1419,1088,-395
BANC,"2/21/2016 5 a.m. PST",1494,1432,1090,-404
BANC,"2/21/2016 6 a.m. PST",1553,1489,1147,-406
BANC,"2/21/2016 7 a.m. PST",1618,1569,1164,-454
BANC,"2/21/2016 8 a.m. PST",1660,1635,1184,-476
BANC,"2/21/2016 9 a.m. PST",1699,1688,1187,-512
BANC,"2/21/2016 10 a.m. PST",1699,1709,1179,-520
BANC,"2/21/2016 11 a.m. PST",1685,1715,1076,-609
BANC,"2/21/2016 12 p.m. PST",1659,1708,1080,-579
BANC,"2/21/2016 1 p.m. PST",1640,1696,1056,-584
BANC,"2/21/2016 2 p.m. PST",1618,1674,1036,-582
BANC,"2/21/2016 3 p.m. PST",1603,1656,1022,-581
BANC,"2/21/2016 4 p.m. PST",1614,1647,1081,-533
BANC,"2/21/2016 5 p.m. PST",1664,1696,1184,-480
BANC,"2/21/2016 6 p.m. PST",1798,1828,1700,-98
BANC,"2/21/2016 7 p.m. PST",1980,1998,1807,-173
BANC,"2/21/2016 8 p.m. PST",2017,1986,1457,-560
BANC,"2/21/2016 9 p.m. PST",1969,1937,1377,-592
BANC,"2/21/2016 10 p.m. PST",1869,1843,1327,-542
BANC,"2/21/2016 11 p.m. PST",1716,1716,1254,-462
BANC,"2/22/2016 12 a.m. PST",1590,1581,1100,-490
BANC,"2/22/2016 1 a.m. PST",1496,1524,1076,-420
BANC,"2/22/2016 2 a.m. PST",1445,1474,1022,-423
BANC,"2/22/2016 3 a.m. PST",1453,1460,1034,-419
BANC,"2/22/2016 4 a.m. PST",1456,1471,1047,-409
BANC,"2/22/2016 5 a.m. PST",1522,1527,1103,-419
BANC,"2/22/2016 6 a.m. PST",1669,1668,1253,-416
BANC,"2/22/2016 7 a.m. PST",1895,1892,1359,-536
BANC,"2/22/2016 8 a.m. PST",1978,1968,1359,-619
BANC,"2/22/2016 9 a.m. PST",1933,1936,1288,-645
BANC,"2/22/2016 10 a.m. PST",1927,1921,1248,-679
BANC,"2/22/2016 11 a.m. PST",1899,1910,1276,-623
BANC,"2/22/2016 12 p.m. PST",1880,1897,1247,-633
BANC,"2/22/2016 1 p.m. PST",1867,1877,1256,-611
BANC,"2/22/2016 2 p.m. PST",1866,1877,1281,-585
BANC,"2/22/2016 3 p.m. PST",1841,1863,1252,-589
BANC,"2/22/2016 4 p.m. PST",1842,1863,1239,-603
BANC,"2/22/2016 5 p.m. PST",1865,1889,1284,-581
BANC,"2/22/2016 6 p.m. PST",1956,2001,1797,-159
BANC,"2/22/2016 7 p.m. PST",2120,2123,1967,-153
BANC,"2/22/2016 8 p.m. PST",2112,2088,1568,-544
BANC,"2/22/2016 9 p.m. PST",2050,2028,1509,-541
BANC,"2/22/2016 10 p.m. PST",1934,1921,1417,-517
BANC,"2/22/2016 11 p.m. PST",1785,1789,1378,-407
BANC,"2/23/2016 12 a.m. PST",1638,1642,1294,-344
BANC,"2/23/2016 1 a.m. PST",1540,1535,1133,-407
BANC,"2/23/2016 2 a.m. PST",1487,1483,1062,-425
BANC,"2/23/2016 3 a.m. PST",1468,1469,1070,-398
BANC,"2/23/2016 4 a.m. PST",1484,1479,1071,-413
BANC,"2/23/2016 5 a.m. PST",1538,1534,1125,-413
BANC,"2/23/2016 6 a.m. PST",1695,1680,1284,-411
BANC,"2/23/2016 7 a.m. PST",1920,1902,1410,-510
BANC,"2/23/2016 8 a.m. PST",1984,1979,1490,-494
BANC,"2/23/2016 9 a.m. PST",1903,1946,1365,-538
BANC,"2/23/2016 10 a.m. PST",1889,1920,1365,-524
BANC,"2/23/2016 11 a.m. PST",1887,1904,1368,-519
BANC,"2/23/2016 12 p.m. PST",1863,1891,1336,-527
BANC,"2/23/2016 1 p.m. PST",1861,1880,1394,-467
BANC,"2/23/2016 2 p.m. PST",1848,1879,1370,-478
BANC,"2/23/2016 3 p.m. PST",1863,1871,1378,-485
BANC,"2/23/2016 4 p.m. PST",1867,1870,1394,-473
BANC,"2/23/2016 5 p.m. PST",1899,1882,1439,-460
BANC,"2/23/2016 6 p.m. PST",1959,1968,1824,-135
BANC,"2/23/2016 7 p.m. PST",2117,2101,2083,-34
BANC,"2/23/2016 8 p.m. PST",2109,2080,1999,-110
BANC,"2/23/2016 9 p.m. PST",2043,2022,1761,-282
BANC,"2/23/2016 10 p.m. PST",1937,1915,1522,-415
BANC,"2/23/2016 11 p.m. PST",1759,1764,1381,-378
BANC,"2/24/2016 12 a.m. PST",1629,1621,1212,-417
BANC,"2/24/2016 1 a.m. PST",1537,1524,1213,-324
BANC,"2/24/2016 2 a.m. PST",1475,1469,1138,-337
BANC,"2/24/2016 3 a.m. PST",1463,1449,1136,-327
BANC,"2/24/2016 4 a.m. PST",1459,1456,1129,-330
BANC,"2/24/2016 5 a.m. PST",1524,1511,1185,-339
BANC,"2/24/2016 6 a.m. PST",1670,1645,1322,-348
BANC,"2/24/2016 7 a.m. PST",1875,1869,1403,-472
BANC,"2/24/2016 8 a.m. PST",1958,1949,1461,-497
BANC,"2/24/2016 9 a.m. PST",1900,1903,1371,-529
BANC,"2/24/2016 10 a.m. PST",1877,1886,1387,-490
BANC,"2/24/2016 11 a.m. PST",1871,1873,1412,-459
BANC,"2/24/2016 12 p.m. PST",1861,1870,1407,-454
BANC,"2/24/2016 1 p.m. PST",1861,1853,1379,-482
BANC,"2/24/2016 2 p.m. PST",1875,1860,1396,-479
BANC,"2/24/2016 3 p.m. PST",1875,1858,1400,-475
BANC,"2/24/2016 4 p.m. PST",1885,1854,1466,-419
BANC,"2/24/2016 5 p.m. PST",1916,1874,1467,-449
BANC,"2/24/2016 6 p.m. PST",1951,1965,1730,-221
BANC,"2/24/2016 7 p.m. PST",2108,2094,1943,-165
BANC,"2/24/2016 8 p.m. PST",2096,2057,1813,-283
BANC,"2/24/2016 9 p.m. PST",2031,2010,1653,-378
BANC,"2/24/2016 10 p.m. PST",1904,1907,1376,-528
BANC,"2/24/2016 11 p.m. PST",1738,1763,1274,-464
BANC,"2/25/2016 12 a.m. PST",1609,1614,1250,-359
BANC,"2/25/2016 1 a.m. PST",1508,1537,1100,-408
BANC,"2/25/2016 2 a.m. PST",1461,1486,1060,-401
BANC,"2/25/2016 3 a.m. PST",1442,1467,1035,-407
BANC,"2/25/2016 4 a.m. PST",1437,1475,1036,-401
BANC,"2/25/2016 5 a.m. PST",1499,1529,1107,-392
BANC,"2/25/2016 6 a.m. PST",1638,1670,1234,-404
BANC,"2/25/2016 7 a.m. PST",1839,1896,1361,-478
BANC,"2/25/2016 8 a.m. PST",1896,1970,1438,-458
BANC,"2/25/2016 9 a.m. PST",1895,1934,1432,-463
BANC,"2/25/2016 10 a.m. PST",1864,1911,1381,-483
BANC,"2/25/2016 11 a.m. PST",1885,1893,1365,-520
BANC,"2/25/2016 12 p.m. PST",1882,1880,1263,-619
BANC,"2/25/2016 1 p.m. PST",1899,1865,1304,-595
BANC,"2/25/2016 2 p.m. PST",1897,1869,1362,-535
BANC,"2/25/2016 3 p.m. PST",1912,1872,1376,-536
BANC,"2/25/2016 4 p.m. PST",1675,1868,1370,-305
BANC,"2/25/2016 5 p.m. PST",1919,1891,1425,-494
BANC,"2/25/2016 6 p.m. PST",1971,1980,1822,-149
BANC,"2/25/2016 7 p.m. PST",2107,2113,1915,-192
BANC,"2/25/2016 8 p.m. PST",2086,2077,1793,-293
BANC,"2/25/2016 9 p.m. PST",2011,2022,1410,-601
BANC,"2/25/2016 10 p.m. PST",1895,1914,1340,-555
BANC,"2/25/2016 11 p.m. PST",1761,1766,1292,-469
BANC,"2/26/2016 12 a.m. PST",1602,1614,1149,-453
BANC,"2/26/2016 1 a.m. PST",1511,1516,1060,-451
BANC,"2/26/2016 2 a.m. PST",1452,1458,1014,-438
BANC,"2/26/2016 3 a.m. PST",1429,1431,980,-449
BANC,"2/26/2016 4 a.m. PST",1428,1438,996,-432
BANC,"2/26/2016 5 a.m. PST",1485,1495,1040,-445
BANC,"2/26/2016 6 a.m. PST",1630,1628,1185,-445
BANC,"2/26/2016 7 a.m. PST",1796,1844,1255,-541
BANC,"2/26/2016 8 a.m. PST",1879,1923,1373,-506
BANC,"2/26/2016 9 a.m. PST",1871,1888,1365,-506
BANC,"2/26/2016 10 a.m. PST",1864,1881,1358,-506
BANC,"2/26/2016 11 a.m. PST",1890,1870,1371,-519
BANC,"2/26/2016 12 p.m. PST",1889,1869,1367,-522
BANC,"2/26/2016 1 p.m. PST",1882,1857,1372,-510
BANC,"2/26/2016 2 p.m. PST",1878,1864,1370,-508
BANC,"2/26/2016 3 p.m. PST",1862,1872,1354,-508
BANC,"2/26/2016 4 p.m. PST",1885,1868,1468,-417
BANC,"2/26/2016 5 p.m. PST",1892,1887,1409,-483
BANC,"2/26/2016 6 p.m. PST",1939,1975,1731,-208
BANC,"2/26/2016 7 p.m. PST",2018,2082,1726,-292
BANC,"2/26/2016 8 p.m. PST",2014,2040,1673,-341
BANC,"2/26/2016 9 p.m. PST",1960,1986,1428,-532
BANC,"2/26/2016 10 p.m. PST",1871,1887,1352,-519
BANC,"2/26/2016 11 p.m. PST",1745,1754,1262,-483
BANC,"2/27/2016 12 a.m. PST",1602,1608,1153,-449
BANC,"2/27/2016 1 a.m. PST",1493,1524,1037,-456
BANC,"2/27/2016 2 a.m. PST",1441,1467,989,-452
BANC,"2/27/2016 3 a.m. PST",1406,1425,973,-433
BANC,"2/27/2016 4 a.m. PST",1387,1412,935,-452
BANC,"2/27/2016 5 a.m. PST",1409,1440,929,-480
BANC,"2/27/2016 6 a.m. PST",1459,1486,1001,-458
BANC,"2/27/2016 7 a.m. PST",1518,1590,963,-555
BANC,"2/27/2016 8 a.m. PST",1522,1635,891,-631
BANC,"2/27/2016 9 a.m. PST",1641,1686,1069,-572
BANC,"2/27/2016 10 a.m. PST",1688,1702,1115,-573
BANC,"2/27/2016 11 a.m. PST",1693,1722,1111,-582
BANC,"2/27/2016 12 p.m. PST",1714,1694,1164,-550
BANC,"2/27/2016 1 p.m. PST",1724,1671,1185,-539
BANC,"2/27/2016 2 p.m. PST",1691,1652,1190,-501
BANC,"2/27/2016 3 p.m. PST",1681,1644,1117,-564
BANC,"2/27/2016 4 p.m. PST",1662,1649,1077,-585
BANC,"2/27/2016 5 p.m. PST",1680,1699,1073,-607
BANC,"2/27/2016 6 p.m. PST",1747,1787,1522,-225
BANC,"2/27/2016 7 p.m. PST",1919,1916,1876,-43
BANC,"2/27/2016 8 p.m. PST",1926,1891,1847,-79
BANC,"2/27/2016 9 p.m. PST",1896,1883,1483,-413
BANC,"2/27/2016 10 p.m. PST",1810,1810,1342,-468
BANC,"2/27/2016 11 p.m. PST",1710,1712,1154,-556
BANC,"2/28/2016 12 a.m. PST",1599,1589,1076,-523
BANC,"2/28/2016 1 a.m. PST",1499,1499,1094,-405
BANC,"2/28/2016 2 a.m. PST",1445,1463,1066,-379
BANC,"2/28/2016 3 a.m. PST",1423,1437,1020,-403
BANC,"2/28/2016 4 a.m. PST",1403,1430,1012,-391
BANC,"2/28/2016 5 a.m. PST",1417,1460,1003,-414
BANC,"2/28/2016 6 a.m. PST",1457,1507,1083,-374
BANC,"2/28/2016 7 a.m. PST",1527,1586,1137,-390
BANC,"2/28/2016 8 a.m. PST",1574,1646,1175,-399
BANC,"2/28/2016 9 a.m. PST",1650,1679,1209,-441
BANC,"2/28/2016 10 a.m. PST",1695,1689,1252,-443
BANC,"2/28/2016 11 a.m. PST",1699,1677,1232,-467
BANC,"2/28/2016 12 p.m. PST",1730,1676,1245,-485
BANC,"2/28/2016 1 p.m. PST",1673,1661,1081,-592
BANC,"2/28/2016 2 p.m. PST",1673,1642,1104,-569
BANC,"2/28/2016 3 p.m. PST",1664,1648,1112,-552
BANC,"2/28/2016 4 p.m. PST",1671,1646,1191,-480
BANC,"2/28/2016 5 p.m. PST",1715,1696,1239,-476
BANC,"2/28/2016 6 p.m. PST",1808,1819,1775,-33
BANC,"2/28/2016 7 p.m. PST",1977,1962,1786,-191
BANC,"2/28/2016 8 p.m. PST",1989,1963,1840,-149
BANC,"2/28/2016 9 p.m. PST",1953,1910,1449,-504
BANC,"2/28/2016 10 p.m. PST",1857,1832,1389,-468
BANC,"2/28/2016 11 p.m. PST",1715,1709,1276,-439
BANC,"2/29/2016 12 a.m. PST",1581,1575,1157,-424
BANC,"2/29/2016 1 a.m. PST",1473,1501,1007,-466
BANC,"2/29/2016 2 a.m. PST",1438,1442,1004,-434
BANC,"2/29/2016 3 a.m. PST",1430,1432,1000,-430
BANC,"2/29/2016 4 a.m. PST",1422,1451,1037,-385
BANC,"2/29/2016 5 a.m. PST",1493,1525,1124,-369
BANC,"2/29/2016 6 a.m. PST",1628,1666,1226,-402
BANC,"2/29/2016 7 a.m. PST",1837,1886,1290,-547
BANC,"2/29/2016 8 a.m. PST",1923,1968,1372,-551
BANC,"2/29/2016 9 a.m. PST",1870,1912,1336,-534
BANC,"2/29/2016 10 a.m. PST",1862,1899,1347,-515
BANC,"2/29/2016 11 a.m. PST",1860,1879,1336,-524
BANC,"2/29/2016 12 p.m. PST",1847,1871,1261,-586
BANC,"2/29/2016 1 p.m. PST",1863,1851,1286,-577
BANC,"2/29/2016 2 p.m. PST",1860,1855,1320,-540
BANC,"2/29/2016 3 p.m. PST",1877,1831,1314,-563
BANC,"2/29/2016 4 p.m. PST",1867,1843,1324,-543
BANC,"2/29/2016 5 p.m. PST",1891,1859,1326,-565
BANC,"2/29/2016 6 p.m. PST",1950,1956,1419,-531
BANC,"2/29/2016 7 p.m. PST",2101,2107,1725,-376
BANC,"2/29/2016 8 p.m. PST",2098,2094,1490,-608
BANC,"2/29/2016 9 p.m. PST",2025,2045,1401,-624
BANC,"2/29/2016 10 p.m. PST",1894,1921,1305,-589
BANC,"2/29/2016 11 p.m. PST",1745,1780,1271,-474
BANC,"3/1/2016 12 a.m. PST",1598,1640,1094,-504
